states,categories,year,between_18,between_1830,between_3045,between_4560,above_60,total,sub_category
ANDHRA PRADESH,TAMPERING DOCUMENTS,2011,0,1,1,0,0,2,COMPUTER
ARUNACHAL PRADESH,TAMPERING DOCUMENTS,2011,0,0,0,0,0,0,COMPUTER
ASSAM,TAMPERING DOCUMENTS,2011,0,0,0,0,0,0,COMPUTER
BIHAR,TAMPERING DOCUMENTS,2011,0,0,0,0,0,0,COMPUTER
CHHATTISGARH,TAMPERING DOCUMENTS,2011,0,0,0,0,0,0,COMPUTER
GOA,TAMPERING DOCUMENTS,2011,0,0,0,0,0,0,COMPUTER
GUJARAT,TAMPERING DOCUMENTS,2011,0,7,5,5,1,18,COMPUTER
HARYANA,TAMPERING DOCUMENTS,2011,0,1,1,0,0,2,COMPUTER
HIMACHAL PRADESH,TAMPERING DOCUMENTS,2011,0,0,0,0,0,0,COMPUTER
JAMMU & KASHMIR,TAMPERING DOCUMENTS,2011,0,0,0,0,0,0,COMPUTER
JHARKHAND,TAMPERING DOCUMENTS,2011,0,0,0,0,0,0,COMPUTER
KARNATAKA,TAMPERING DOCUMENTS,2011,0,0,0,0,0,0,COMPUTER
KERALA,TAMPERING DOCUMENTS,2011,0,2,0,0,0,2,COMPUTER
MADHYA PRADESH,TAMPERING DOCUMENTS,2011,0,2,0,0,0,2,COMPUTER
MAHARASHTRA,TAMPERING DOCUMENTS,2011,0,9,0,0,0,9,COMPUTER
MANIPUR,TAMPERING DOCUMENTS,2011,0,0,0,0,0,0,COMPUTER
MEGHALAYA,TAMPERING DOCUMENTS,2011,0,0,0,0,0,0,COMPUTER
MIZORAM,TAMPERING DOCUMENTS,2011,0,0,0,0,0,0,COMPUTER
NAGALAND,TAMPERING DOCUMENTS,2011,0,0,0,0,0,0,COMPUTER
ORISSA,TAMPERING DOCUMENTS,2011,0,0,0,0,0,0,COMPUTER
PUNJAB,TAMPERING DOCUMENTS,2011,0,6,2,0,0,8,COMPUTER
RAJASTHAN,TAMPERING DOCUMENTS,2011,1,3,2,0,0,6,COMPUTER
SIKKIM,TAMPERING DOCUMENTS,2011,0,0,0,0,0,0,COMPUTER
TAMIL NADU,TAMPERING DOCUMENTS,2011,0,0,0,0,0,0,COMPUTER
TRIPURA,TAMPERING DOCUMENTS,2011,0,0,0,0,0,0,COMPUTER
UTTAR PRADESH,TAMPERING DOCUMENTS,2011,0,7,6,2,0,15,COMPUTER
UTTARAKHAND,TAMPERING DOCUMENTS,2011,0,0,1,0,0,1,COMPUTER
WEST BENGAL,TAMPERING DOCUMENTS,2011,0,0,0,0,0,0,COMPUTER
TOTAL-STATES,TAMPERING DOCUMENTS,2011,1,38,18,7,1,65,COMPUTER
A & N ISLANDS,TAMPERING DOCUMENTS,2011,0,0,0,0,0,0,COMPUTER
CHANDIGARH,TAMPERING DOCUMENTS,2011,0,0,0,0,0,0,COMPUTER
D & N HAVELI,TAMPERING DOCUMENTS,2011,0,0,0,0,0,0,COMPUTER
DAMAN & DIU,TAMPERING DOCUMENTS,2011,0,0,0,0,0,0,COMPUTER
DELHI,TAMPERING DOCUMENTS,2011,0,0,1,0,0,1,COMPUTER
LAKSHADWEEP,TAMPERING DOCUMENTS,2011,0,0,0,0,0,0,COMPUTER
PUDUCHERRY,TAMPERING DOCUMENTS,2011,0,0,0,0,0,0,COMPUTER
TOTAL-UTs,TAMPERING DOCUMENTS,2011,0,0,1,0,0,1,COMPUTER
TOTAL-INDIA,TAMPERING DOCUMENTS,2011,1,38,19,7,1,66,COMPUTER
ANDHRA PRADESH,LOSS OR DAMAGE,2011,3,100,60,10,0,173,COMPUTER
ARUNACHAL PRADESH,LOSS OR DAMAGE,2011,0,0,0,0,0,0,COMPUTER
ASSAM,LOSS OR DAMAGE,2011,0,0,6,0,0,6,COMPUTER
BIHAR,LOSS OR DAMAGE,2011,0,2,0,0,0,2,COMPUTER
CHHATTISGARH,LOSS OR DAMAGE,2011,0,0,0,0,0,0,COMPUTER
GOA,LOSS OR DAMAGE,2011,0,0,0,0,0,0,COMPUTER
GUJARAT,LOSS OR DAMAGE,2011,0,6,7,0,0,13,COMPUTER
HARYANA,LOSS OR DAMAGE,2011,0,3,2,0,0,5,COMPUTER
HIMACHAL PRADESH,LOSS OR DAMAGE,2011,0,3,1,0,0,4,COMPUTER
JAMMU & KASHMIR,LOSS OR DAMAGE,2011,0,0,0,0,0,0,COMPUTER
JHARKHAND,LOSS OR DAMAGE,2011,0,0,0,0,0,0,COMPUTER
KARNATAKA,LOSS OR DAMAGE,2011,0,15,2,0,0,17,COMPUTER
KERALA,LOSS OR DAMAGE,2011,3,27,14,3,0,47,COMPUTER
MADHYA PRADESH,LOSS OR DAMAGE,2011,0,22,12,1,1,36,COMPUTER
MAHARASHTRA,LOSS OR DAMAGE,2011,0,28,7,11,0,46,COMPUTER
MANIPUR,LOSS OR DAMAGE,2011,0,0,0,0,0,0,COMPUTER
MEGHALAYA,LOSS OR DAMAGE,2011,0,3,0,0,0,3,COMPUTER
MIZORAM,LOSS OR DAMAGE,2011,0,0,0,0,0,0,COMPUTER
NAGALAND,LOSS OR DAMAGE,2011,0,0,0,0,0,0,COMPUTER
ORISSA,LOSS OR DAMAGE,2011,0,0,0,0,0,0,COMPUTER
PUNJAB,LOSS OR DAMAGE,2011,0,5,4,0,0,9,COMPUTER
RAJASTHAN,LOSS OR DAMAGE,2011,0,23,10,3,0,36,COMPUTER
SIKKIM,LOSS OR DAMAGE,2011,0,0,0,0,0,0,COMPUTER
TAMIL NADU,LOSS OR DAMAGE,2011,0,5,13,1,0,19,COMPUTER
TRIPURA,LOSS OR DAMAGE,2011,0,0,0,0,0,0,COMPUTER
UTTAR PRADESH,LOSS OR DAMAGE,2011,0,11,29,5,0,45,COMPUTER
UTTARAKHAND,LOSS OR DAMAGE,2011,0,0,0,0,0,0,COMPUTER
WEST BENGAL,LOSS OR DAMAGE,2011,0,0,7,1,0,8,COMPUTER
TOTAL-STATES,LOSS OR DAMAGE,2011,6,253,174,35,1,469,COMPUTER
A & N ISLANDS,LOSS OR DAMAGE,2011,0,0,0,0,0,0,COMPUTER
CHANDIGARH,LOSS OR DAMAGE,2011,0,0,4,0,0,4,COMPUTER
D & N HAVELI,LOSS OR DAMAGE,2011,0,1,0,0,0,1,COMPUTER
DAMAN & DIU,LOSS OR DAMAGE,2011,0,0,1,0,0,1,COMPUTER
DELHI,LOSS OR DAMAGE,2011,2,5,3,1,0,11,COMPUTER
LAKSHADWEEP,LOSS OR DAMAGE,2011,0,0,0,0,0,0,COMPUTER
PUDUCHERRY,LOSS OR DAMAGE,2011,0,1,0,0,0,1,COMPUTER
TOTAL-UTs,LOSS OR DAMAGE,2011,2,7,8,1,0,18,COMPUTER
TOTAL-INDIA,LOSS OR DAMAGE,2011,8,260,182,36,1,487,COMPUTER
ANDHRA PRADESH,HACKING ,2011,0,5,1,0,0,6,COMPUTER
ARUNACHAL PRADESH,HACKING ,2011,0,0,2,0,0,2,COMPUTER
ASSAM,HACKING ,2011,0,0,0,0,0,0,COMPUTER
BIHAR,HACKING ,2011,0,2,0,0,0,2,COMPUTER
CHHATTISGARH,HACKING ,2011,0,0,0,0,0,0,COMPUTER
GOA,HACKING ,2011,0,2,0,0,0,2,COMPUTER
GUJARAT,HACKING ,2011,0,0,0,0,0,0,COMPUTER
HARYANA,HACKING ,2011,0,3,0,0,0,3,COMPUTER
HIMACHAL PRADESH,HACKING ,2011,0,0,0,0,0,0,COMPUTER
JAMMU & KASHMIR,HACKING ,2011,0,2,0,0,0,2,COMPUTER
JHARKHAND,HACKING ,2011,0,0,0,0,0,0,COMPUTER
KARNATAKA,HACKING ,2011,0,0,0,0,0,0,COMPUTER
KERALA,HACKING ,2011,0,3,0,0,0,3,COMPUTER
MADHYA PRADESH,HACKING ,2011,0,11,3,0,0,14,COMPUTER
MAHARASHTRA,HACKING ,2011,0,1,13,0,0,14,COMPUTER
MANIPUR,HACKING ,2011,0,0,0,0,0,0,COMPUTER
MEGHALAYA,HACKING ,2011,0,0,0,0,0,0,COMPUTER
MIZORAM,HACKING ,2011,0,0,0,0,0,0,COMPUTER
NAGALAND,HACKING ,2011,0,0,0,0,0,0,COMPUTER
ORISSA,HACKING ,2011,0,0,0,0,0,0,COMPUTER
PUNJAB,HACKING ,2011,0,0,0,0,0,0,COMPUTER
RAJASTHAN,HACKING ,2011,0,0,0,0,0,0,COMPUTER
SIKKIM,HACKING ,2011,0,0,1,0,0,1,COMPUTER
TAMIL NADU,HACKING ,2011,0,8,7,0,0,15,COMPUTER
TRIPURA,HACKING ,2011,0,0,0,0,0,0,COMPUTER
UTTAR PRADESH,HACKING ,2011,0,1,0,0,0,1,COMPUTER
UTTARAKHAND,HACKING ,2011,0,0,0,0,0,0,COMPUTER
WEST BENGAL,HACKING ,2011,0,0,0,0,0,0,COMPUTER
TOTAL-STATES,HACKING ,2011,0,38,27,0,0,65,COMPUTER
A & N ISLANDS,HACKING ,2011,0,0,0,0,0,0,COMPUTER
CHANDIGARH,HACKING ,2011,0,0,0,0,0,0,COMPUTER
D & N HAVELI,HACKING ,2011,0,0,0,0,0,0,COMPUTER
DAMAN & DIU,HACKING ,2011,0,0,0,0,0,0,COMPUTER
DELHI,HACKING ,2011,0,0,0,0,0,0,COMPUTER
LAKSHADWEEP,HACKING ,2011,0,0,0,0,0,0,COMPUTER
PUDUCHERRY,HACKING ,2011,0,0,0,0,0,0,COMPUTER
TOTAL-UTs,HACKING ,2011,0,0,0,0,0,0,COMPUTER
TOTAL-INDIA,HACKING ,2011,0,38,27,0,0,65,COMPUTER
ANDHRA PRADESH,TRANSMISSION IN ELECTRONIC FORM ,2011,2,36,21,2,0,61,COMPUTER
ARUNACHAL PRADESH,TRANSMISSION IN ELECTRONIC FORM ,2011,0,0,1,4,0,5,COMPUTER
ASSAM,TRANSMISSION IN ELECTRONIC FORM ,2011,0,0,0,0,0,0,COMPUTER
BIHAR,TRANSMISSION IN ELECTRONIC FORM ,2011,0,2,0,0,0,2,COMPUTER
CHHATTISGARH,TRANSMISSION IN ELECTRONIC FORM ,2011,0,0,0,0,0,0,COMPUTER
GOA,TRANSMISSION IN ELECTRONIC FORM ,2011,0,2,0,0,0,2,COMPUTER
GUJARAT,TRANSMISSION IN ELECTRONIC FORM ,2011,0,4,1,0,0,5,COMPUTER
HARYANA,TRANSMISSION IN ELECTRONIC FORM ,2011,0,3,2,0,0,5,COMPUTER
HIMACHAL PRADESH,TRANSMISSION IN ELECTRONIC FORM ,2011,0,1,0,0,0,1,COMPUTER
JAMMU & KASHMIR,TRANSMISSION IN ELECTRONIC FORM ,2011,0,0,0,0,0,0,COMPUTER
JHARKHAND,TRANSMISSION IN ELECTRONIC FORM ,2011,0,0,0,0,0,0,COMPUTER
KARNATAKA,TRANSMISSION IN ELECTRONIC FORM ,2011,0,15,0,2,0,17,COMPUTER
KERALA,TRANSMISSION IN ELECTRONIC FORM ,2011,0,52,22,6,0,80,COMPUTER
MADHYA PRADESH,TRANSMISSION IN ELECTRONIC FORM ,2011,10,27,6,0,0,43,COMPUTER
MAHARASHTRA,TRANSMISSION IN ELECTRONIC FORM ,2011,2,54,20,3,0,79,COMPUTER
MANIPUR,TRANSMISSION IN ELECTRONIC FORM ,2011,0,0,0,0,0,0,COMPUTER
MEGHALAYA,TRANSMISSION IN ELECTRONIC FORM ,2011,0,0,0,0,0,0,COMPUTER
MIZORAM,TRANSMISSION IN ELECTRONIC FORM ,2011,0,1,0,0,0,1,COMPUTER
NAGALAND,TRANSMISSION IN ELECTRONIC FORM ,2011,0,0,0,0,0,0,COMPUTER
ORISSA,TRANSMISSION IN ELECTRONIC FORM ,2011,0,0,1,0,0,1,COMPUTER
PUNJAB,TRANSMISSION IN ELECTRONIC FORM ,2011,0,12,6,0,1,19,COMPUTER
RAJASTHAN,TRANSMISSION IN ELECTRONIC FORM ,2011,0,45,14,8,1,68,COMPUTER
SIKKIM,TRANSMISSION IN ELECTRONIC FORM ,2011,0,0,0,0,0,0,COMPUTER
TAMIL NADU,TRANSMISSION IN ELECTRONIC FORM ,2011,0,5,2,2,0,9,COMPUTER
TRIPURA,TRANSMISSION IN ELECTRONIC FORM ,2011,0,0,0,0,0,0,COMPUTER
UTTAR PRADESH,TRANSMISSION IN ELECTRONIC FORM ,2011,0,22,11,4,0,37,COMPUTER
UTTARAKHAND,TRANSMISSION IN ELECTRONIC FORM ,2011,0,0,1,0,0,1,COMPUTER
WEST BENGAL,TRANSMISSION IN ELECTRONIC FORM ,2011,0,0,3,0,0,3,COMPUTER
TOTAL-STATES,TRANSMISSION IN ELECTRONIC FORM ,2011,14,281,111,31,2,439,COMPUTER
A & N ISLANDS,TRANSMISSION IN ELECTRONIC FORM ,2011,0,0,0,0,0,0,COMPUTER
CHANDIGARH,TRANSMISSION IN ELECTRONIC FORM ,2011,0,0,1,0,0,1,COMPUTER
D & N HAVELI,TRANSMISSION IN ELECTRONIC FORM ,2011,0,0,0,0,0,0,COMPUTER
DAMAN & DIU,TRANSMISSION IN ELECTRONIC FORM ,2011,0,0,0,0,0,0,COMPUTER
DELHI,TRANSMISSION IN ELECTRONIC FORM ,2011,0,2,1,0,0,3,COMPUTER
LAKSHADWEEP,TRANSMISSION IN ELECTRONIC FORM ,2011,0,0,0,0,0,0,COMPUTER
PUDUCHERRY,TRANSMISSION IN ELECTRONIC FORM ,2011,0,0,0,0,0,0,COMPUTER
TOTAL-UTs,TRANSMISSION IN ELECTRONIC FORM ,2011,0,2,2,0,0,4,COMPUTER
TOTAL-INDIA,TRANSMISSION IN ELECTRONIC FORM ,2011,14,283,113,31,2,443,COMPUTER
ANDHRA PRADESH,FAILURE - OF COMPLIANCE ,2011,0,0,0,0,0,0,COMPUTER
ARUNACHAL PRADESH,FAILURE - OF COMPLIANCE ,2011,0,0,0,0,0,0,COMPUTER
ASSAM,FAILURE - OF COMPLIANCE ,2011,0,0,0,0,0,0,COMPUTER
BIHAR,FAILURE - OF COMPLIANCE ,2011,0,0,0,0,0,0,COMPUTER
CHHATTISGARH,FAILURE - OF COMPLIANCE ,2011,0,0,0,0,0,0,COMPUTER
GOA,FAILURE - OF COMPLIANCE ,2011,0,0,0,0,0,0,COMPUTER
GUJARAT,FAILURE - OF COMPLIANCE ,2011,0,0,0,0,0,0,COMPUTER
HARYANA,FAILURE - OF COMPLIANCE ,2011,0,0,0,0,0,0,COMPUTER
HIMACHAL PRADESH,FAILURE - OF COMPLIANCE ,2011,0,0,0,0,0,0,COMPUTER
JAMMU & KASHMIR,FAILURE - OF COMPLIANCE ,2011,0,0,0,0,0,0,COMPUTER
JHARKHAND,FAILURE - OF COMPLIANCE ,2011,0,0,0,0,0,0,COMPUTER
KARNATAKA,FAILURE - OF COMPLIANCE ,2011,0,0,0,0,0,0,COMPUTER
KERALA,FAILURE - OF COMPLIANCE ,2011,0,0,0,0,0,0,COMPUTER
MADHYA PRADESH,FAILURE - OF COMPLIANCE ,2011,0,0,0,0,0,0,COMPUTER
MAHARASHTRA,FAILURE - OF COMPLIANCE ,2011,0,1,2,1,0,4,COMPUTER
MANIPUR,FAILURE - OF COMPLIANCE ,2011,0,0,0,0,0,0,COMPUTER
MEGHALAYA,FAILURE - OF COMPLIANCE ,2011,0,0,0,0,0,0,COMPUTER
MIZORAM,FAILURE - OF COMPLIANCE ,2011,0,0,0,0,0,0,COMPUTER
NAGALAND,FAILURE - OF COMPLIANCE ,2011,0,0,0,0,0,0,COMPUTER
ORISSA,FAILURE - OF COMPLIANCE ,2011,0,0,0,0,0,0,COMPUTER
PUNJAB,FAILURE - OF COMPLIANCE ,2011,0,0,0,0,0,0,COMPUTER
RAJASTHAN,FAILURE - OF COMPLIANCE ,2011,0,0,0,0,0,0,COMPUTER
SIKKIM,FAILURE - OF COMPLIANCE ,2011,0,0,0,0,0,0,COMPUTER
TAMIL NADU,FAILURE - OF COMPLIANCE ,2011,0,0,0,0,0,0,COMPUTER
TRIPURA,FAILURE - OF COMPLIANCE ,2011,0,0,0,0,0,0,COMPUTER
UTTAR PRADESH,FAILURE - OF COMPLIANCE ,2011,0,0,0,0,0,0,COMPUTER
UTTARAKHAND,FAILURE - OF COMPLIANCE ,2011,0,0,0,0,0,0,COMPUTER
WEST BENGAL,FAILURE - OF COMPLIANCE ,2011,0,0,0,0,0,0,COMPUTER
TOTAL-STATES,FAILURE - OF COMPLIANCE ,2011,0,1,2,1,0,4,COMPUTER
A & N ISLANDS,FAILURE - OF COMPLIANCE ,2011,0,0,0,0,0,0,COMPUTER
CHANDIGARH,FAILURE - OF COMPLIANCE ,2011,0,0,0,0,0,0,COMPUTER
D & N HAVELI,FAILURE - OF COMPLIANCE ,2011,0,0,0,0,0,0,COMPUTER
DAMAN & DIU,FAILURE - OF COMPLIANCE ,2011,0,0,0,0,0,0,COMPUTER
DELHI,FAILURE - OF COMPLIANCE ,2011,0,0,0,0,0,0,COMPUTER
LAKSHADWEEP,FAILURE - OF COMPLIANCE ,2011,0,0,0,0,0,0,COMPUTER
PUDUCHERRY,FAILURE - OF COMPLIANCE ,2011,0,0,0,0,0,0,COMPUTER
TOTAL-UTs,FAILURE - OF COMPLIANCE ,2011,0,0,0,0,0,0,COMPUTER
TOTAL-INDIA,FAILURE - OF COMPLIANCE ,2011,0,1,2,1,0,4,COMPUTER
ANDHRA PRADESH,FAILURE - TO ASSIST IN DECRYPTING THE INFORMATION INTERCEPTED BY GOVT AGENCY ,2011,0,0,0,0,0,0,COMPUTER
ARUNACHAL PRADESH,FAILURE - TO ASSIST IN DECRYPTING THE INFORMATION INTERCEPTED BY GOVT AGENCY ,2011,0,0,0,0,0,0,COMPUTER
ASSAM,FAILURE - TO ASSIST IN DECRYPTING THE INFORMATION INTERCEPTED BY GOVT AGENCY ,2011,0,0,0,0,0,0,COMPUTER
BIHAR,FAILURE - TO ASSIST IN DECRYPTING THE INFORMATION INTERCEPTED BY GOVT AGENCY ,2011,0,0,0,0,0,0,COMPUTER
CHHATTISGARH,FAILURE - TO ASSIST IN DECRYPTING THE INFORMATION INTERCEPTED BY GOVT AGENCY ,2011,0,0,0,0,0,0,COMPUTER
GOA,FAILURE - TO ASSIST IN DECRYPTING THE INFORMATION INTERCEPTED BY GOVT AGENCY ,2011,0,0,0,0,0,0,COMPUTER
GUJARAT,FAILURE - TO ASSIST IN DECRYPTING THE INFORMATION INTERCEPTED BY GOVT AGENCY ,2011,0,0,0,0,0,0,COMPUTER
HARYANA,FAILURE - TO ASSIST IN DECRYPTING THE INFORMATION INTERCEPTED BY GOVT AGENCY ,2011,0,0,0,0,0,0,COMPUTER
HIMACHAL PRADESH,FAILURE - TO ASSIST IN DECRYPTING THE INFORMATION INTERCEPTED BY GOVT AGENCY ,2011,0,0,0,0,0,0,COMPUTER
JAMMU & KASHMIR,FAILURE - TO ASSIST IN DECRYPTING THE INFORMATION INTERCEPTED BY GOVT AGENCY ,2011,0,0,0,0,0,0,COMPUTER
JHARKHAND,FAILURE - TO ASSIST IN DECRYPTING THE INFORMATION INTERCEPTED BY GOVT AGENCY ,2011,0,0,0,0,0,0,COMPUTER
KARNATAKA,FAILURE - TO ASSIST IN DECRYPTING THE INFORMATION INTERCEPTED BY GOVT AGENCY ,2011,0,0,0,0,0,0,COMPUTER
KERALA,FAILURE - TO ASSIST IN DECRYPTING THE INFORMATION INTERCEPTED BY GOVT AGENCY ,2011,0,0,0,0,0,0,COMPUTER
MADHYA PRADESH,FAILURE - TO ASSIST IN DECRYPTING THE INFORMATION INTERCEPTED BY GOVT AGENCY ,2011,0,0,0,0,0,0,COMPUTER
MAHARASHTRA,FAILURE - TO ASSIST IN DECRYPTING THE INFORMATION INTERCEPTED BY GOVT AGENCY ,2011,0,0,0,0,0,0,COMPUTER
MANIPUR,FAILURE - TO ASSIST IN DECRYPTING THE INFORMATION INTERCEPTED BY GOVT AGENCY ,2011,0,0,0,0,0,0,COMPUTER
MEGHALAYA,FAILURE - TO ASSIST IN DECRYPTING THE INFORMATION INTERCEPTED BY GOVT AGENCY ,2011,0,0,0,0,0,0,COMPUTER
MIZORAM,FAILURE - TO ASSIST IN DECRYPTING THE INFORMATION INTERCEPTED BY GOVT AGENCY ,2011,0,0,0,0,0,0,COMPUTER
NAGALAND,FAILURE - TO ASSIST IN DECRYPTING THE INFORMATION INTERCEPTED BY GOVT AGENCY ,2011,0,0,0,0,0,0,COMPUTER
ORISSA,FAILURE - TO ASSIST IN DECRYPTING THE INFORMATION INTERCEPTED BY GOVT AGENCY ,2011,0,0,0,0,0,0,COMPUTER
PUNJAB,FAILURE - TO ASSIST IN DECRYPTING THE INFORMATION INTERCEPTED BY GOVT AGENCY ,2011,0,0,0,0,0,0,COMPUTER
RAJASTHAN,FAILURE - TO ASSIST IN DECRYPTING THE INFORMATION INTERCEPTED BY GOVT AGENCY ,2011,0,0,0,0,0,0,COMPUTER
SIKKIM,FAILURE - TO ASSIST IN DECRYPTING THE INFORMATION INTERCEPTED BY GOVT AGENCY ,2011,0,0,0,0,0,0,COMPUTER
TAMIL NADU,FAILURE - TO ASSIST IN DECRYPTING THE INFORMATION INTERCEPTED BY GOVT AGENCY ,2011,0,0,0,0,0,0,COMPUTER
TRIPURA,FAILURE - TO ASSIST IN DECRYPTING THE INFORMATION INTERCEPTED BY GOVT AGENCY ,2011,0,0,0,0,0,0,COMPUTER
UTTAR PRADESH,FAILURE - TO ASSIST IN DECRYPTING THE INFORMATION INTERCEPTED BY GOVT AGENCY ,2011,0,0,0,0,0,0,COMPUTER
UTTARAKHAND,FAILURE - TO ASSIST IN DECRYPTING THE INFORMATION INTERCEPTED BY GOVT AGENCY ,2011,0,0,0,0,0,0,COMPUTER
WEST BENGAL,FAILURE - TO ASSIST IN DECRYPTING THE INFORMATION INTERCEPTED BY GOVT AGENCY ,2011,0,0,0,0,0,0,COMPUTER
TOTAL-STATES,FAILURE - TO ASSIST IN DECRYPTING THE INFORMATION INTERCEPTED BY GOVT AGENCY ,2011,0,0,0,0,0,0,COMPUTER
A & N ISLANDS,FAILURE - TO ASSIST IN DECRYPTING THE INFORMATION INTERCEPTED BY GOVT AGENCY ,2011,0,0,0,0,0,0,COMPUTER
CHANDIGARH,FAILURE - TO ASSIST IN DECRYPTING THE INFORMATION INTERCEPTED BY GOVT AGENCY ,2011,0,0,0,0,0,0,COMPUTER
D & N HAVELI,FAILURE - TO ASSIST IN DECRYPTING THE INFORMATION INTERCEPTED BY GOVT AGENCY ,2011,0,0,0,0,0,0,COMPUTER
DAMAN & DIU,FAILURE - TO ASSIST IN DECRYPTING THE INFORMATION INTERCEPTED BY GOVT AGENCY ,2011,0,0,0,0,0,0,COMPUTER
DELHI,FAILURE - TO ASSIST IN DECRYPTING THE INFORMATION INTERCEPTED BY GOVT AGENCY ,2011,0,0,0,0,0,0,COMPUTER
LAKSHADWEEP,FAILURE - TO ASSIST IN DECRYPTING THE INFORMATION INTERCEPTED BY GOVT AGENCY ,2011,0,0,0,0,0,0,COMPUTER
PUDUCHERRY,FAILURE - TO ASSIST IN DECRYPTING THE INFORMATION INTERCEPTED BY GOVT AGENCY ,2011,0,0,0,0,0,0,COMPUTER
TOTAL-UTs,FAILURE - TO ASSIST IN DECRYPTING THE INFORMATION INTERCEPTED BY GOVT AGENCY ,2011,0,0,0,0,0,0,COMPUTER
TOTAL-INDIA,FAILURE - TO ASSIST IN DECRYPTING THE INFORMATION INTERCEPTED BY GOVT AGENCY ,2011,0,0,0,0,0,0,COMPUTER
ANDHRA PRADESH,UN-AUTHORISED ACCESS ,2011,0,0,0,0,0,0,COMPUTER
ARUNACHAL PRADESH,UN-AUTHORISED ACCESS ,2011,0,0,0,0,0,0,COMPUTER
ASSAM,UN-AUTHORISED ACCESS ,2011,0,0,0,0,0,0,COMPUTER
BIHAR,UN-AUTHORISED ACCESS ,2011,0,0,0,0,0,0,COMPUTER
CHHATTISGARH,UN-AUTHORISED ACCESS ,2011,0,0,0,0,0,0,COMPUTER
GOA,UN-AUTHORISED ACCESS ,2011,0,0,0,0,0,0,COMPUTER
GUJARAT,UN-AUTHORISED ACCESS ,2011,0,0,0,0,0,0,COMPUTER
HARYANA,UN-AUTHORISED ACCESS ,2011,0,0,0,0,0,0,COMPUTER
HIMACHAL PRADESH,UN-AUTHORISED ACCESS ,2011,0,0,0,0,0,0,COMPUTER
JAMMU & KASHMIR,UN-AUTHORISED ACCESS ,2011,0,0,0,0,0,0,COMPUTER
JHARKHAND,UN-AUTHORISED ACCESS ,2011,0,0,0,0,0,0,COMPUTER
KARNATAKA,UN-AUTHORISED ACCESS ,2011,0,0,0,0,0,0,COMPUTER
KERALA,UN-AUTHORISED ACCESS ,2011,0,0,0,0,0,0,COMPUTER
MADHYA PRADESH,UN-AUTHORISED ACCESS ,2011,0,0,0,0,0,0,COMPUTER
MAHARASHTRA,UN-AUTHORISED ACCESS ,2011,0,8,0,0,0,8,COMPUTER
MANIPUR,UN-AUTHORISED ACCESS ,2011,0,0,0,0,0,0,COMPUTER
MEGHALAYA,UN-AUTHORISED ACCESS ,2011,0,0,0,0,0,0,COMPUTER
MIZORAM,UN-AUTHORISED ACCESS ,2011,0,0,0,0,0,0,COMPUTER
NAGALAND,UN-AUTHORISED ACCESS ,2011,0,0,0,0,0,0,COMPUTER
ORISSA,UN-AUTHORISED ACCESS ,2011,0,0,0,0,0,0,COMPUTER
PUNJAB,UN-AUTHORISED ACCESS ,2011,0,0,0,0,0,0,COMPUTER
RAJASTHAN,UN-AUTHORISED ACCESS ,2011,0,0,0,0,0,0,COMPUTER
SIKKIM,UN-AUTHORISED ACCESS ,2011,0,0,0,0,0,0,COMPUTER
TAMIL NADU,UN-AUTHORISED ACCESS ,2011,0,0,0,0,0,0,COMPUTER
TRIPURA,UN-AUTHORISED ACCESS ,2011,0,0,0,0,0,0,COMPUTER
UTTAR PRADESH,UN-AUTHORISED ACCESS ,2011,0,3,3,1,0,7,COMPUTER
UTTARAKHAND,UN-AUTHORISED ACCESS ,2011,0,0,0,0,0,0,COMPUTER
WEST BENGAL,UN-AUTHORISED ACCESS ,2011,0,0,0,0,0,0,COMPUTER
TOTAL-STATES,UN-AUTHORISED ACCESS ,2011,0,11,3,1,0,15,COMPUTER
A & N ISLANDS,UN-AUTHORISED ACCESS ,2011,0,0,0,0,0,0,COMPUTER
CHANDIGARH,UN-AUTHORISED ACCESS ,2011,0,0,0,0,0,0,COMPUTER
D & N HAVELI,UN-AUTHORISED ACCESS ,2011,0,0,0,0,0,0,COMPUTER
DAMAN & DIU,UN-AUTHORISED ACCESS ,2011,0,0,0,0,0,0,COMPUTER
DELHI,UN-AUTHORISED ACCESS ,2011,0,0,0,0,0,0,COMPUTER
LAKSHADWEEP,UN-AUTHORISED ACCESS ,2011,0,0,0,0,0,0,COMPUTER
PUDUCHERRY,UN-AUTHORISED ACCESS ,2011,0,0,0,0,0,0,COMPUTER
TOTAL-UTs,UN-AUTHORISED ACCESS ,2011,0,0,0,0,0,0,COMPUTER
TOTAL-INDIA,UN-AUTHORISED ACCESS ,2011,0,11,3,1,0,15,COMPUTER
ANDHRA PRADESH,OBTAINING LICENCE BY MISREPRESENTATION OF FACT ,2011,0,0,0,0,0,0,COMPUTER
ARUNACHAL PRADESH,OBTAINING LICENCE BY MISREPRESENTATION OF FACT ,2011,0,0,0,0,0,0,COMPUTER
ASSAM,OBTAINING LICENCE BY MISREPRESENTATION OF FACT ,2011,0,0,0,0,0,0,COMPUTER
BIHAR,OBTAINING LICENCE BY MISREPRESENTATION OF FACT ,2011,0,0,0,0,0,0,COMPUTER
CHHATTISGARH,OBTAINING LICENCE BY MISREPRESENTATION OF FACT ,2011,0,0,0,0,0,0,COMPUTER
GOA,OBTAINING LICENCE BY MISREPRESENTATION OF FACT ,2011,0,0,0,0,0,0,COMPUTER
GUJARAT,OBTAINING LICENCE BY MISREPRESENTATION OF FACT ,2011,0,0,0,0,0,0,COMPUTER
HARYANA,OBTAINING LICENCE BY MISREPRESENTATION OF FACT ,2011,0,0,0,0,0,0,COMPUTER
HIMACHAL PRADESH,OBTAINING LICENCE BY MISREPRESENTATION OF FACT ,2011,0,0,0,0,0,0,COMPUTER
JAMMU & KASHMIR,OBTAINING LICENCE BY MISREPRESENTATION OF FACT ,2011,0,0,0,0,0,0,COMPUTER
JHARKHAND,OBTAINING LICENCE BY MISREPRESENTATION OF FACT ,2011,0,0,0,0,0,0,COMPUTER
KARNATAKA,OBTAINING LICENCE BY MISREPRESENTATION OF FACT ,2011,0,0,0,0,0,0,COMPUTER
KERALA,OBTAINING LICENCE BY MISREPRESENTATION OF FACT ,2011,0,0,0,0,0,0,COMPUTER
MADHYA PRADESH,OBTAINING LICENCE BY MISREPRESENTATION OF FACT ,2011,0,0,0,0,0,0,COMPUTER
MAHARASHTRA,OBTAINING LICENCE BY MISREPRESENTATION OF FACT ,2011,0,0,0,0,0,0,COMPUTER
MANIPUR,OBTAINING LICENCE BY MISREPRESENTATION OF FACT ,2011,0,0,0,0,0,0,COMPUTER
MEGHALAYA,OBTAINING LICENCE BY MISREPRESENTATION OF FACT ,2011,0,0,0,0,0,0,COMPUTER
MIZORAM,OBTAINING LICENCE BY MISREPRESENTATION OF FACT ,2011,0,0,0,0,0,0,COMPUTER
NAGALAND,OBTAINING LICENCE BY MISREPRESENTATION OF FACT ,2011,0,0,0,0,0,0,COMPUTER
ORISSA,OBTAINING LICENCE BY MISREPRESENTATION OF FACT ,2011,0,0,0,0,0,0,COMPUTER
PUNJAB,OBTAINING LICENCE BY MISREPRESENTATION OF FACT ,2011,0,0,0,0,0,0,COMPUTER
RAJASTHAN,OBTAINING LICENCE BY MISREPRESENTATION OF FACT ,2011,0,0,0,0,0,0,COMPUTER
SIKKIM,OBTAINING LICENCE BY MISREPRESENTATION OF FACT ,2011,0,0,0,0,0,0,COMPUTER
TAMIL NADU,OBTAINING LICENCE BY MISREPRESENTATION OF FACT ,2011,0,0,0,0,0,0,COMPUTER
TRIPURA,OBTAINING LICENCE BY MISREPRESENTATION OF FACT ,2011,0,0,0,0,0,0,COMPUTER
UTTAR PRADESH,OBTAINING LICENCE BY MISREPRESENTATION OF FACT ,2011,0,0,0,0,0,0,COMPUTER
UTTARAKHAND,OBTAINING LICENCE BY MISREPRESENTATION OF FACT ,2011,0,0,0,0,0,0,COMPUTER
WEST BENGAL,OBTAINING LICENCE BY MISREPRESENTATION OF FACT ,2011,0,0,0,0,0,0,COMPUTER
TOTAL-STATES,OBTAINING LICENCE BY MISREPRESENTATION OF FACT ,2011,0,0,0,0,0,0,COMPUTER
A & N ISLANDS,OBTAINING LICENCE BY MISREPRESENTATION OF FACT ,2011,0,0,0,0,0,0,COMPUTER
CHANDIGARH,OBTAINING LICENCE BY MISREPRESENTATION OF FACT ,2011,0,0,0,0,0,0,COMPUTER
D & N HAVELI,OBTAINING LICENCE BY MISREPRESENTATION OF FACT ,2011,0,0,0,0,0,0,COMPUTER
DAMAN & DIU,OBTAINING LICENCE BY MISREPRESENTATION OF FACT ,2011,0,0,0,0,0,0,COMPUTER
DELHI,OBTAINING LICENCE BY MISREPRESENTATION OF FACT ,2011,0,0,0,0,0,0,COMPUTER
LAKSHADWEEP,OBTAINING LICENCE BY MISREPRESENTATION OF FACT ,2011,0,0,0,0,0,0,COMPUTER
PUDUCHERRY,OBTAINING LICENCE BY MISREPRESENTATION OF FACT ,2011,0,0,0,0,0,0,COMPUTER
TOTAL-UTs,OBTAINING LICENCE BY MISREPRESENTATION OF FACT ,2011,0,0,0,0,0,0,COMPUTER
TOTAL-INDIA,OBTAINING LICENCE BY MISREPRESENTATION OF FACT ,2011,0,0,0,0,0,0,COMPUTER
ANDHRA PRADESH,PUBLISHING FALSE DIGITAL SIGNATURE CERTIFICATE ,2011,0,0,0,0,0,0,COMPUTER
ARUNACHAL PRADESH,PUBLISHING FALSE DIGITAL SIGNATURE CERTIFICATE ,2011,0,0,0,0,0,0,COMPUTER
ASSAM,PUBLISHING FALSE DIGITAL SIGNATURE CERTIFICATE ,2011,0,0,0,0,0,0,COMPUTER
BIHAR,PUBLISHING FALSE DIGITAL SIGNATURE CERTIFICATE ,2011,0,0,0,0,0,0,COMPUTER
CHHATTISGARH,PUBLISHING FALSE DIGITAL SIGNATURE CERTIFICATE ,2011,0,1,0,0,0,1,COMPUTER
GOA,PUBLISHING FALSE DIGITAL SIGNATURE CERTIFICATE ,2011,0,0,0,0,0,0,COMPUTER
GUJARAT,PUBLISHING FALSE DIGITAL SIGNATURE CERTIFICATE ,2011,0,0,0,0,0,0,COMPUTER
HARYANA,PUBLISHING FALSE DIGITAL SIGNATURE CERTIFICATE ,2011,0,0,0,0,0,0,COMPUTER
HIMACHAL PRADESH,PUBLISHING FALSE DIGITAL SIGNATURE CERTIFICATE ,2011,0,0,0,0,0,0,COMPUTER
JAMMU & KASHMIR,PUBLISHING FALSE DIGITAL SIGNATURE CERTIFICATE ,2011,0,0,0,0,0,0,COMPUTER
JHARKHAND,PUBLISHING FALSE DIGITAL SIGNATURE CERTIFICATE ,2011,0,0,0,0,0,0,COMPUTER
KARNATAKA,PUBLISHING FALSE DIGITAL SIGNATURE CERTIFICATE ,2011,0,0,0,0,0,0,COMPUTER
KERALA,PUBLISHING FALSE DIGITAL SIGNATURE CERTIFICATE ,2011,0,0,0,0,0,0,COMPUTER
MADHYA PRADESH,PUBLISHING FALSE DIGITAL SIGNATURE CERTIFICATE ,2011,0,0,0,0,0,0,COMPUTER
MAHARASHTRA,PUBLISHING FALSE DIGITAL SIGNATURE CERTIFICATE ,2011,0,0,0,0,0,0,COMPUTER
MANIPUR,PUBLISHING FALSE DIGITAL SIGNATURE CERTIFICATE ,2011,0,0,0,0,0,0,COMPUTER
MEGHALAYA,PUBLISHING FALSE DIGITAL SIGNATURE CERTIFICATE ,2011,0,0,0,0,0,0,COMPUTER
MIZORAM,PUBLISHING FALSE DIGITAL SIGNATURE CERTIFICATE ,2011,0,0,0,0,0,0,COMPUTER
NAGALAND,PUBLISHING FALSE DIGITAL SIGNATURE CERTIFICATE ,2011,0,0,0,0,0,0,COMPUTER
ORISSA,PUBLISHING FALSE DIGITAL SIGNATURE CERTIFICATE ,2011,0,0,0,0,0,0,COMPUTER
PUNJAB,PUBLISHING FALSE DIGITAL SIGNATURE CERTIFICATE ,2011,0,0,0,0,0,0,COMPUTER
RAJASTHAN,PUBLISHING FALSE DIGITAL SIGNATURE CERTIFICATE ,2011,0,0,0,0,0,0,COMPUTER
SIKKIM,PUBLISHING FALSE DIGITAL SIGNATURE CERTIFICATE ,2011,0,0,0,0,0,0,COMPUTER
TAMIL NADU,PUBLISHING FALSE DIGITAL SIGNATURE CERTIFICATE ,2011,0,0,0,0,0,0,COMPUTER
TRIPURA,PUBLISHING FALSE DIGITAL SIGNATURE CERTIFICATE ,2011,0,0,0,0,0,0,COMPUTER
UTTAR PRADESH,PUBLISHING FALSE DIGITAL SIGNATURE CERTIFICATE ,2011,0,0,0,0,0,0,COMPUTER
UTTARAKHAND,PUBLISHING FALSE DIGITAL SIGNATURE CERTIFICATE ,2011,0,0,0,0,0,0,COMPUTER
WEST BENGAL,PUBLISHING FALSE DIGITAL SIGNATURE CERTIFICATE ,2011,0,0,0,0,0,0,COMPUTER
TOTAL-STATES,PUBLISHING FALSE DIGITAL SIGNATURE CERTIFICATE ,2011,0,1,0,0,0,1,COMPUTER
A & N ISLANDS,PUBLISHING FALSE DIGITAL SIGNATURE CERTIFICATE ,2011,0,0,0,0,0,0,COMPUTER
CHANDIGARH,PUBLISHING FALSE DIGITAL SIGNATURE CERTIFICATE ,2011,0,0,0,0,0,0,COMPUTER
D & N HAVELI,PUBLISHING FALSE DIGITAL SIGNATURE CERTIFICATE ,2011,0,0,0,0,0,0,COMPUTER
DAMAN & DIU,PUBLISHING FALSE DIGITAL SIGNATURE CERTIFICATE ,2011,0,0,0,0,0,0,COMPUTER
DELHI,PUBLISHING FALSE DIGITAL SIGNATURE CERTIFICATE ,2011,0,0,0,0,0,0,COMPUTER
LAKSHADWEEP,PUBLISHING FALSE DIGITAL SIGNATURE CERTIFICATE ,2011,0,0,0,0,0,0,COMPUTER
PUDUCHERRY,PUBLISHING FALSE DIGITAL SIGNATURE CERTIFICATE ,2011,0,0,0,0,0,0,COMPUTER
TOTAL-UTs,PUBLISHING FALSE DIGITAL SIGNATURE CERTIFICATE ,2011,0,0,0,0,0,0,COMPUTER
TOTAL-INDIA,PUBLISHING FALSE DIGITAL SIGNATURE CERTIFICATE ,2011,0,1,0,0,0,1,COMPUTER
ANDHRA PRADESH,FRAUD DIGITAL SIGNATURE CERTIFICATE ,2011,0,0,0,0,0,0,COMPUTER
ARUNACHAL PRADESH,FRAUD DIGITAL SIGNATURE CERTIFICATE ,2011,0,0,0,0,0,0,COMPUTER
ASSAM,FRAUD DIGITAL SIGNATURE CERTIFICATE ,2011,0,0,0,0,0,0,COMPUTER
BIHAR,FRAUD DIGITAL SIGNATURE CERTIFICATE ,2011,0,0,0,0,0,0,COMPUTER
CHHATTISGARH,FRAUD DIGITAL SIGNATURE CERTIFICATE ,2011,0,0,0,0,0,0,COMPUTER
GOA,FRAUD DIGITAL SIGNATURE CERTIFICATE ,2011,0,0,0,0,0,0,COMPUTER
GUJARAT,FRAUD DIGITAL SIGNATURE CERTIFICATE ,2011,0,0,0,0,0,0,COMPUTER
HARYANA,FRAUD DIGITAL SIGNATURE CERTIFICATE ,2011,0,0,0,0,0,0,COMPUTER
HIMACHAL PRADESH,FRAUD DIGITAL SIGNATURE CERTIFICATE ,2011,0,0,0,0,0,0,COMPUTER
JAMMU & KASHMIR,FRAUD DIGITAL SIGNATURE CERTIFICATE ,2011,0,0,0,0,0,0,COMPUTER
JHARKHAND,FRAUD DIGITAL SIGNATURE CERTIFICATE ,2011,0,0,0,0,0,0,COMPUTER
KARNATAKA,FRAUD DIGITAL SIGNATURE CERTIFICATE ,2011,0,0,0,0,0,0,COMPUTER
KERALA,FRAUD DIGITAL SIGNATURE CERTIFICATE ,2011,0,0,0,0,0,0,COMPUTER
MADHYA PRADESH,FRAUD DIGITAL SIGNATURE CERTIFICATE ,2011,0,1,1,0,0,2,COMPUTER
MAHARASHTRA,FRAUD DIGITAL SIGNATURE CERTIFICATE ,2011,0,5,0,0,0,5,COMPUTER
MANIPUR,FRAUD DIGITAL SIGNATURE CERTIFICATE ,2011,0,0,0,0,0,0,COMPUTER
MEGHALAYA,FRAUD DIGITAL SIGNATURE CERTIFICATE ,2011,0,0,0,0,0,0,COMPUTER
MIZORAM,FRAUD DIGITAL SIGNATURE CERTIFICATE ,2011,0,0,0,0,0,0,COMPUTER
NAGALAND,FRAUD DIGITAL SIGNATURE CERTIFICATE ,2011,0,0,0,0,0,0,COMPUTER
ORISSA,FRAUD DIGITAL SIGNATURE CERTIFICATE ,2011,0,0,0,0,0,0,COMPUTER
PUNJAB,FRAUD DIGITAL SIGNATURE CERTIFICATE ,2011,0,1,0,0,0,1,COMPUTER
RAJASTHAN,FRAUD DIGITAL SIGNATURE CERTIFICATE ,2011,0,0,0,0,0,0,COMPUTER
SIKKIM,FRAUD DIGITAL SIGNATURE CERTIFICATE ,2011,0,0,0,0,0,0,COMPUTER
TAMIL NADU,FRAUD DIGITAL SIGNATURE CERTIFICATE ,2011,0,0,0,0,0,0,COMPUTER
TRIPURA,FRAUD DIGITAL SIGNATURE CERTIFICATE ,2011,0,0,0,0,0,0,COMPUTER
UTTAR PRADESH,FRAUD DIGITAL SIGNATURE CERTIFICATE ,2011,0,0,0,0,0,0,COMPUTER
UTTARAKHAND,FRAUD DIGITAL SIGNATURE CERTIFICATE ,2011,0,0,0,0,0,0,COMPUTER
WEST BENGAL,FRAUD DIGITAL SIGNATURE CERTIFICATE ,2011,0,0,0,0,0,0,COMPUTER
TOTAL-STATES,FRAUD DIGITAL SIGNATURE CERTIFICATE ,2011,0,7,1,0,0,8,COMPUTER
A & N ISLANDS,FRAUD DIGITAL SIGNATURE CERTIFICATE ,2011,0,0,0,0,0,0,COMPUTER
CHANDIGARH,FRAUD DIGITAL SIGNATURE CERTIFICATE ,2011,0,0,0,0,0,0,COMPUTER
D & N HAVELI,FRAUD DIGITAL SIGNATURE CERTIFICATE ,2011,0,0,0,0,0,0,COMPUTER
DAMAN & DIU,FRAUD DIGITAL SIGNATURE CERTIFICATE ,2011,0,0,0,0,0,0,COMPUTER
DELHI,FRAUD DIGITAL SIGNATURE CERTIFICATE ,2011,0,0,0,0,0,0,COMPUTER
LAKSHADWEEP,FRAUD DIGITAL SIGNATURE CERTIFICATE ,2011,0,0,0,0,0,0,COMPUTER
PUDUCHERRY,FRAUD DIGITAL SIGNATURE CERTIFICATE ,2011,0,0,0,0,0,0,COMPUTER
TOTAL-UTs,FRAUD DIGITAL SIGNATURE CERTIFICATE ,2011,0,0,0,0,0,0,COMPUTER
TOTAL-INDIA,FRAUD DIGITAL SIGNATURE CERTIFICATE ,2011,0,7,1,0,0,8,COMPUTER
ANDHRA PRADESH,BREACH OF CONFIDENTIALITY ,2011,0,0,0,0,0,0,COMPUTER
ARUNACHAL PRADESH,BREACH OF CONFIDENTIALITY ,2011,0,0,0,0,0,0,COMPUTER
ASSAM,BREACH OF CONFIDENTIALITY ,2011,0,0,0,0,0,0,COMPUTER
BIHAR,BREACH OF CONFIDENTIALITY ,2011,0,0,0,0,0,0,COMPUTER
CHHATTISGARH,BREACH OF CONFIDENTIALITY ,2011,0,1,0,0,0,1,COMPUTER
GOA,BREACH OF CONFIDENTIALITY ,2011,0,0,0,0,0,0,COMPUTER
GUJARAT,BREACH OF CONFIDENTIALITY ,2011,0,0,0,0,0,0,COMPUTER
HARYANA,BREACH OF CONFIDENTIALITY ,2011,0,0,0,0,0,0,COMPUTER
HIMACHAL PRADESH,BREACH OF CONFIDENTIALITY ,2011,0,0,0,0,0,0,COMPUTER
JAMMU & KASHMIR,BREACH OF CONFIDENTIALITY ,2011,0,1,0,0,0,1,COMPUTER
JHARKHAND,BREACH OF CONFIDENTIALITY ,2011,0,0,0,0,0,0,COMPUTER
KARNATAKA,BREACH OF CONFIDENTIALITY ,2011,0,0,0,0,0,0,COMPUTER
KERALA,BREACH OF CONFIDENTIALITY ,2011,0,2,1,0,0,3,COMPUTER
MADHYA PRADESH,BREACH OF CONFIDENTIALITY ,2011,0,0,0,0,0,0,COMPUTER
MAHARASHTRA,BREACH OF CONFIDENTIALITY ,2011,0,0,1,1,0,2,COMPUTER
MANIPUR,BREACH OF CONFIDENTIALITY ,2011,0,0,0,0,0,0,COMPUTER
MEGHALAYA,BREACH OF CONFIDENTIALITY ,2011,0,0,0,0,0,0,COMPUTER
MIZORAM,BREACH OF CONFIDENTIALITY ,2011,0,0,0,0,0,0,COMPUTER
NAGALAND,BREACH OF CONFIDENTIALITY ,2011,0,0,0,0,0,0,COMPUTER
ORISSA,BREACH OF CONFIDENTIALITY ,2011,0,0,0,0,0,0,COMPUTER
PUNJAB,BREACH OF CONFIDENTIALITY ,2011,0,1,0,0,0,1,COMPUTER
RAJASTHAN,BREACH OF CONFIDENTIALITY ,2011,0,0,0,0,0,0,COMPUTER
SIKKIM,BREACH OF CONFIDENTIALITY ,2011,0,0,0,0,0,0,COMPUTER
TAMIL NADU,BREACH OF CONFIDENTIALITY ,2011,0,0,0,0,0,0,COMPUTER
TRIPURA,BREACH OF CONFIDENTIALITY ,2011,0,0,0,0,0,0,COMPUTER
UTTAR PRADESH,BREACH OF CONFIDENTIALITY ,2011,0,8,7,3,0,18,COMPUTER
UTTARAKHAND,BREACH OF CONFIDENTIALITY ,2011,0,0,1,0,0,1,COMPUTER
WEST BENGAL,BREACH OF CONFIDENTIALITY ,2011,0,0,0,0,0,0,COMPUTER
TOTAL-STATES,BREACH OF CONFIDENTIALITY ,2011,0,13,10,4,0,27,COMPUTER
A & N ISLANDS,BREACH OF CONFIDENTIALITY ,2011,0,0,0,0,0,0,COMPUTER
CHANDIGARH,BREACH OF CONFIDENTIALITY ,2011,0,0,0,0,0,0,COMPUTER
D & N HAVELI,BREACH OF CONFIDENTIALITY ,2011,0,0,0,0,0,0,COMPUTER
DAMAN & DIU,BREACH OF CONFIDENTIALITY ,2011,0,0,0,0,0,0,COMPUTER
DELHI,BREACH OF CONFIDENTIALITY ,2011,0,0,0,0,0,0,COMPUTER
LAKSHADWEEP,BREACH OF CONFIDENTIALITY ,2011,0,0,0,0,0,0,COMPUTER
PUDUCHERRY,BREACH OF CONFIDENTIALITY ,2011,0,0,0,0,0,0,COMPUTER
TOTAL-UTs,BREACH OF CONFIDENTIALITY ,2011,0,0,0,0,0,0,COMPUTER
TOTAL-INDIA,BREACH OF CONFIDENTIALITY ,2011,0,13,10,4,0,27,COMPUTER
ANDHRA PRADESH,OTHER ,2011,0,0,0,0,0,0,COMPUTER
ARUNACHAL PRADESH,OTHER ,2011,0,0,0,0,0,0,COMPUTER
ASSAM,OTHER ,2011,0,0,0,0,0,0,COMPUTER
BIHAR,OTHER ,2011,0,0,0,0,0,0,COMPUTER
CHHATTISGARH,OTHER ,2011,0,0,0,0,0,0,COMPUTER
GOA,OTHER ,2011,0,0,0,0,0,0,COMPUTER
GUJARAT,OTHER ,2011,0,0,0,0,0,0,COMPUTER
HARYANA,OTHER ,2011,0,0,0,0,0,0,COMPUTER
HIMACHAL PRADESH,OTHER ,2011,0,0,0,0,0,0,COMPUTER
JAMMU & KASHMIR,OTHER ,2011,0,0,0,0,0,0,COMPUTER
JHARKHAND,OTHER ,2011,0,9,0,0,0,9,COMPUTER
KARNATAKA,OTHER ,2011,0,0,0,0,0,0,COMPUTER
KERALA,OTHER ,2011,0,0,0,0,0,0,COMPUTER
MADHYA PRADESH,OTHER ,2011,0,0,0,0,0,0,COMPUTER
MAHARASHTRA,OTHER ,2011,2,34,19,3,1,59,COMPUTER
MANIPUR,OTHER ,2011,0,0,0,0,0,0,COMPUTER
MEGHALAYA,OTHER ,2011,0,0,0,0,0,0,COMPUTER
MIZORAM,OTHER ,2011,0,0,0,0,0,0,COMPUTER
NAGALAND,OTHER ,2011,0,0,0,0,0,0,COMPUTER
ORISSA,OTHER ,2011,0,0,0,0,0,0,COMPUTER
PUNJAB,OTHER ,2011,0,0,0,0,0,0,COMPUTER
RAJASTHAN,OTHER ,2011,0,0,0,0,0,0,COMPUTER
SIKKIM,OTHER ,2011,0,0,0,0,0,0,COMPUTER
TAMIL NADU,OTHER ,2011,0,0,0,0,0,0,COMPUTER
TRIPURA,OTHER ,2011,0,0,0,0,0,0,COMPUTER
UTTAR PRADESH,OTHER ,2011,0,0,0,0,0,0,COMPUTER
UTTARAKHAND,OTHER ,2011,0,0,0,0,0,0,COMPUTER
WEST BENGAL,OTHER ,2011,0,0,0,0,0,0,COMPUTER
TOTAL-STATES,OTHER ,2011,2,43,19,3,1,68,COMPUTER
A & N ISLANDS,OTHER ,2011,0,0,0,0,0,0,COMPUTER
CHANDIGARH,OTHER ,2011,0,0,0,0,0,0,COMPUTER
D & N HAVELI,OTHER ,2011,0,0,0,0,0,0,COMPUTER
DAMAN & DIU,OTHER ,2011,0,0,0,0,0,0,COMPUTER
DELHI,OTHER ,2011,0,0,0,0,0,0,COMPUTER
LAKSHADWEEP,OTHER ,2011,0,0,0,0,0,0,COMPUTER
PUDUCHERRY,OTHER ,2011,0,0,0,0,0,0,COMPUTER
TOTAL-UTs,OTHER ,2011,0,0,0,0,0,0,COMPUTER
TOTAL-INDIA,OTHER ,2011,2,43,19,3,1,68,COMPUTER
ANDHRA PRADESH,TOTAL ,2011,5,142,83,12,0,242,COMPUTER
ARUNACHAL PRADESH,TOTAL ,2011,0,0,3,4,0,7,COMPUTER
ASSAM,TOTAL ,2011,0,0,6,0,0,6,COMPUTER
BIHAR,TOTAL ,2011,0,6,0,0,0,6,COMPUTER
CHHATTISGARH,TOTAL ,2011,0,2,0,0,0,2,COMPUTER
GOA,TOTAL ,2011,0,4,0,0,0,4,COMPUTER
GUJARAT,TOTAL ,2011,0,17,13,5,1,36,COMPUTER
HARYANA,TOTAL ,2011,0,10,5,0,0,15,COMPUTER
HIMACHAL PRADESH,TOTAL ,2011,0,4,1,0,0,5,COMPUTER
JAMMU & KASHMIR,TOTAL ,2011,0,3,0,0,0,3,COMPUTER
JHARKHAND,TOTAL ,2011,0,9,0,0,0,9,COMPUTER
KARNATAKA,TOTAL ,2011,0,30,2,2,0,34,COMPUTER
KERALA,TOTAL ,2011,3,86,37,9,0,135,COMPUTER
MADHYA PRADESH,TOTAL ,2011,10,63,22,1,1,97,COMPUTER
MAHARASHTRA,TOTAL ,2011,4,140,62,19,1,226,COMPUTER
MANIPUR,TOTAL ,2011,0,0,0,0,0,0,COMPUTER
MEGHALAYA,TOTAL ,2011,0,3,0,0,0,3,COMPUTER
MIZORAM,TOTAL ,2011,0,1,0,0,0,1,COMPUTER
NAGALAND,TOTAL ,2011,0,0,0,0,0,0,COMPUTER
ORISSA,TOTAL ,2011,0,0,1,0,0,1,COMPUTER
PUNJAB,TOTAL ,2011,0,25,12,0,1,38,COMPUTER
RAJASTHAN,TOTAL ,2011,1,71,26,11,1,110,COMPUTER
SIKKIM,TOTAL ,2011,0,0,1,0,0,1,COMPUTER
TAMIL NADU,TOTAL ,2011,0,18,22,3,0,43,COMPUTER
TRIPURA,TOTAL ,2011,0,0,0,0,0,0,COMPUTER
UTTAR PRADESH,TOTAL ,2011,0,52,56,15,0,123,COMPUTER
UTTARAKHAND,TOTAL ,2011,0,0,3,0,0,3,COMPUTER
WEST BENGAL,TOTAL ,2011,0,0,10,1,0,11,COMPUTER
TOTAL-STATES,TOTAL ,2011,23,686,365,82,5,1161,COMPUTER
A & N ISLANDS,TOTAL ,2011,0,0,0,0,0,0,COMPUTER
CHANDIGARH,TOTAL ,2011,0,0,5,0,0,5,COMPUTER
D & N HAVELI,TOTAL ,2011,0,1,0,0,0,1,COMPUTER
DAMAN & DIU,TOTAL ,2011,0,0,1,0,0,1,COMPUTER
DELHI,TOTAL ,2011,2,7,5,1,0,15,COMPUTER
LAKSHADWEEP,TOTAL ,2011,0,0,0,0,0,0,COMPUTER
PUDUCHERRY,TOTAL ,2011,0,1,0,0,0,1,COMPUTER
TOTAL-UTs,TOTAL ,2011,2,9,11,1,0,23,COMPUTER
TOTAL-INDIA,TOTAL ,2011,25,695,376,83,5,1184,COMPUTER
ANDHRA PRADESH,OFFENCES BY OR AGAINST PUBLIC SERVANT ,2011,0,0,0,0,0,0,COMPUTER
ARUNACHAL PRADESH,OFFENCES BY OR AGAINST PUBLIC SERVANT ,2011,0,0,0,0,0,0,COMPUTER
ASSAM,OFFENCES BY OR AGAINST PUBLIC SERVANT ,2011,0,0,0,0,0,0,COMPUTER
BIHAR,OFFENCES BY OR AGAINST PUBLIC SERVANT ,2011,0,0,0,0,0,0,COMPUTER
CHHATTISGARH,OFFENCES BY OR AGAINST PUBLIC SERVANT ,2011,0,0,0,0,0,0,COMPUTER
GOA,OFFENCES BY OR AGAINST PUBLIC SERVANT ,2011,0,0,0,0,0,0,COMPUTER
GUJARAT,OFFENCES BY OR AGAINST PUBLIC SERVANT ,2011,0,0,0,0,0,0,COMPUTER
HARYANA,OFFENCES BY OR AGAINST PUBLIC SERVANT ,2011,0,0,0,0,0,0,COMPUTER
HIMACHAL PRADESH,OFFENCES BY OR AGAINST PUBLIC SERVANT ,2011,0,0,0,0,0,0,COMPUTER
JAMMU & KASHMIR,OFFENCES BY OR AGAINST PUBLIC SERVANT ,2011,0,0,0,0,0,0,COMPUTER
JHARKHAND,OFFENCES BY OR AGAINST PUBLIC SERVANT ,2011,0,0,0,0,0,0,COMPUTER
KARNATAKA,OFFENCES BY OR AGAINST PUBLIC SERVANT ,2011,0,0,0,0,0,0,COMPUTER
KERALA,OFFENCES BY OR AGAINST PUBLIC SERVANT ,2011,0,0,0,0,0,0,COMPUTER
MADHYA PRADESH,OFFENCES BY OR AGAINST PUBLIC SERVANT ,2011,0,0,0,0,0,0,COMPUTER
MAHARASHTRA,OFFENCES BY OR AGAINST PUBLIC SERVANT ,2011,0,3,0,0,0,3,COMPUTER
MANIPUR,OFFENCES BY OR AGAINST PUBLIC SERVANT ,2011,0,0,0,0,0,0,COMPUTER
MEGHALAYA,OFFENCES BY OR AGAINST PUBLIC SERVANT ,2011,0,0,0,0,0,0,COMPUTER
MIZORAM,OFFENCES BY OR AGAINST PUBLIC SERVANT ,2011,0,0,0,0,0,0,COMPUTER
NAGALAND,OFFENCES BY OR AGAINST PUBLIC SERVANT ,2011,0,0,0,0,0,0,COMPUTER
ORISSA,OFFENCES BY OR AGAINST PUBLIC SERVANT ,2011,0,0,0,0,0,0,COMPUTER
PUNJAB,OFFENCES BY OR AGAINST PUBLIC SERVANT ,2011,0,0,0,0,0,0,COMPUTER
RAJASTHAN,OFFENCES BY OR AGAINST PUBLIC SERVANT ,2011,0,0,0,0,0,0,COMPUTER
SIKKIM,OFFENCES BY OR AGAINST PUBLIC SERVANT ,2011,0,0,0,0,0,0,COMPUTER
TAMIL NADU,OFFENCES BY OR AGAINST PUBLIC SERVANT ,2011,0,0,0,0,0,0,COMPUTER
TRIPURA,OFFENCES BY OR AGAINST PUBLIC SERVANT ,2011,0,0,0,0,0,0,COMPUTER
UTTAR PRADESH,OFFENCES BY OR AGAINST PUBLIC SERVANT ,2011,0,0,0,0,0,0,COMPUTER
UTTARAKHAND,OFFENCES BY OR AGAINST PUBLIC SERVANT ,2011,0,0,0,0,0,0,COMPUTER
WEST BENGAL,OFFENCES BY OR AGAINST PUBLIC SERVANT ,2011,0,0,0,0,0,0,COMPUTER
TOTAL-STATES,OFFENCES BY OR AGAINST PUBLIC SERVANT ,2011,0,3,0,0,0,3,COMPUTER
A & N ISLANDS,OFFENCES BY OR AGAINST PUBLIC SERVANT ,2011,0,0,0,0,0,0,COMPUTER
CHANDIGARH,OFFENCES BY OR AGAINST PUBLIC SERVANT ,2011,0,0,0,0,0,0,COMPUTER
D & N HAVELI,OFFENCES BY OR AGAINST PUBLIC SERVANT ,2011,0,0,0,0,0,0,COMPUTER
DAMAN & DIU,OFFENCES BY OR AGAINST PUBLIC SERVANT ,2011,0,0,0,0,0,0,COMPUTER
DELHI,OFFENCES BY OR AGAINST PUBLIC SERVANT ,2011,0,0,0,0,0,0,COMPUTER
LAKSHADWEEP,OFFENCES BY OR AGAINST PUBLIC SERVANT ,2011,0,0,0,0,0,0,COMPUTER
PUDUCHERRY,OFFENCES BY OR AGAINST PUBLIC SERVANT ,2011,0,0,0,0,0,0,COMPUTER
TOTAL-UTs,OFFENCES BY OR AGAINST PUBLIC SERVANT ,2011,0,0,0,0,0,0,COMPUTER
TOTAL-INDIA,OFFENCES BY OR AGAINST PUBLIC SERVANT ,2011,0,3,0,0,0,3,COMPUTER
ANDHRA PRADESH,FALSE ELECTRONIC EVIDENCE ,2011,0,0,0,0,0,0,COMPUTER
ARUNACHAL PRADESH,FALSE ELECTRONIC EVIDENCE ,2011,0,0,0,0,0,0,COMPUTER
ASSAM,FALSE ELECTRONIC EVIDENCE ,2011,0,0,0,0,0,0,COMPUTER
BIHAR,FALSE ELECTRONIC EVIDENCE ,2011,0,0,0,0,0,0,COMPUTER
CHHATTISGARH,FALSE ELECTRONIC EVIDENCE ,2011,0,0,0,0,0,0,COMPUTER
GOA,FALSE ELECTRONIC EVIDENCE ,2011,0,0,0,0,0,0,COMPUTER
GUJARAT,FALSE ELECTRONIC EVIDENCE ,2011,0,0,0,0,0,0,COMPUTER
HARYANA,FALSE ELECTRONIC EVIDENCE ,2011,0,0,0,0,0,0,COMPUTER
HIMACHAL PRADESH,FALSE ELECTRONIC EVIDENCE ,2011,0,0,0,0,0,0,COMPUTER
JAMMU & KASHMIR,FALSE ELECTRONIC EVIDENCE ,2011,0,0,0,0,0,0,COMPUTER
JHARKHAND,FALSE ELECTRONIC EVIDENCE ,2011,0,0,0,0,0,0,COMPUTER
KARNATAKA,FALSE ELECTRONIC EVIDENCE ,2011,0,0,0,0,0,0,COMPUTER
KERALA,FALSE ELECTRONIC EVIDENCE ,2011,0,0,0,0,0,0,COMPUTER
MADHYA PRADESH,FALSE ELECTRONIC EVIDENCE ,2011,0,1,0,0,0,1,COMPUTER
MAHARASHTRA,FALSE ELECTRONIC EVIDENCE ,2011,0,0,0,0,0,0,COMPUTER
MANIPUR,FALSE ELECTRONIC EVIDENCE ,2011,0,0,0,0,0,0,COMPUTER
MEGHALAYA,FALSE ELECTRONIC EVIDENCE ,2011,0,0,0,0,0,0,COMPUTER
MIZORAM,FALSE ELECTRONIC EVIDENCE ,2011,0,0,0,0,0,0,COMPUTER
NAGALAND,FALSE ELECTRONIC EVIDENCE ,2011,0,0,0,0,0,0,COMPUTER
ORISSA,FALSE ELECTRONIC EVIDENCE ,2011,0,0,0,0,0,0,COMPUTER
PUNJAB,FALSE ELECTRONIC EVIDENCE ,2011,0,0,0,0,0,0,COMPUTER
RAJASTHAN,FALSE ELECTRONIC EVIDENCE ,2011,0,0,0,0,0,0,COMPUTER
SIKKIM,FALSE ELECTRONIC EVIDENCE ,2011,0,0,0,0,0,0,COMPUTER
TAMIL NADU,FALSE ELECTRONIC EVIDENCE ,2011,0,0,0,0,0,0,COMPUTER
TRIPURA,FALSE ELECTRONIC EVIDENCE ,2011,0,0,0,0,0,0,COMPUTER
UTTAR PRADESH,FALSE ELECTRONIC EVIDENCE ,2011,0,0,0,0,0,0,COMPUTER
UTTARAKHAND,FALSE ELECTRONIC EVIDENCE ,2011,0,0,0,0,0,0,COMPUTER
WEST BENGAL,FALSE ELECTRONIC EVIDENCE ,2011,0,0,0,0,0,0,COMPUTER
TOTAL-STATES,FALSE ELECTRONIC EVIDENCE ,2011,0,1,0,0,0,1,COMPUTER
A & N ISLANDS,FALSE ELECTRONIC EVIDENCE ,2011,0,0,0,0,0,0,COMPUTER
CHANDIGARH,FALSE ELECTRONIC EVIDENCE ,2011,0,0,0,0,0,0,COMPUTER
D & N HAVELI,FALSE ELECTRONIC EVIDENCE ,2011,0,0,0,0,0,0,COMPUTER
DAMAN & DIU,FALSE ELECTRONIC EVIDENCE ,2011,0,0,0,0,0,0,COMPUTER
DELHI,FALSE ELECTRONIC EVIDENCE ,2011,0,0,0,0,0,0,COMPUTER
LAKSHADWEEP,FALSE ELECTRONIC EVIDENCE ,2011,0,0,0,0,0,0,COMPUTER
PUDUCHERRY,FALSE ELECTRONIC EVIDENCE ,2011,0,0,0,0,0,0,COMPUTER
TOTAL-UTs,FALSE ELECTRONIC EVIDENCE ,2011,0,0,0,0,0,0,COMPUTER
TOTAL-INDIA,FALSE ELECTRONIC EVIDENCE ,2011,0,1,0,0,0,1,COMPUTER
ANDHRA PRADESH,DESTRUCTION OF ELECTRONIC EVIDENCE ,2011,0,0,0,0,0,0,COMPUTER
ARUNACHAL PRADESH,DESTRUCTION OF ELECTRONIC EVIDENCE ,2011,0,0,0,0,0,0,COMPUTER
ASSAM,DESTRUCTION OF ELECTRONIC EVIDENCE ,2011,0,0,0,0,0,0,COMPUTER
BIHAR,DESTRUCTION OF ELECTRONIC EVIDENCE ,2011,0,0,0,0,0,0,COMPUTER
CHHATTISGARH,DESTRUCTION OF ELECTRONIC EVIDENCE ,2011,0,0,0,0,0,0,COMPUTER
GOA,DESTRUCTION OF ELECTRONIC EVIDENCE ,2011,0,0,0,0,0,0,COMPUTER
GUJARAT,DESTRUCTION OF ELECTRONIC EVIDENCE ,2011,0,2,2,4,0,8,COMPUTER
HARYANA,DESTRUCTION OF ELECTRONIC EVIDENCE ,2011,0,0,0,0,0,0,COMPUTER
HIMACHAL PRADESH,DESTRUCTION OF ELECTRONIC EVIDENCE ,2011,0,0,0,0,0,0,COMPUTER
JAMMU & KASHMIR,DESTRUCTION OF ELECTRONIC EVIDENCE ,2011,0,0,0,0,0,0,COMPUTER
JHARKHAND,DESTRUCTION OF ELECTRONIC EVIDENCE ,2011,0,0,0,0,0,0,COMPUTER
KARNATAKA,DESTRUCTION OF ELECTRONIC EVIDENCE ,2011,0,2,0,0,0,2,COMPUTER
KERALA,DESTRUCTION OF ELECTRONIC EVIDENCE ,2011,0,0,0,0,0,0,COMPUTER
MADHYA PRADESH,DESTRUCTION OF ELECTRONIC EVIDENCE ,2011,0,0,0,0,0,0,COMPUTER
MAHARASHTRA,DESTRUCTION OF ELECTRONIC EVIDENCE ,2011,0,0,0,0,0,0,COMPUTER
MANIPUR,DESTRUCTION OF ELECTRONIC EVIDENCE ,2011,0,0,0,0,0,0,COMPUTER
MEGHALAYA,DESTRUCTION OF ELECTRONIC EVIDENCE ,2011,0,0,0,0,0,0,COMPUTER
MIZORAM,DESTRUCTION OF ELECTRONIC EVIDENCE ,2011,0,0,0,0,0,0,COMPUTER
NAGALAND,DESTRUCTION OF ELECTRONIC EVIDENCE ,2011,0,0,0,0,0,0,COMPUTER
ORISSA,DESTRUCTION OF ELECTRONIC EVIDENCE ,2011,0,0,0,0,0,0,COMPUTER
PUNJAB,DESTRUCTION OF ELECTRONIC EVIDENCE ,2011,0,0,0,0,0,0,COMPUTER
RAJASTHAN,DESTRUCTION OF ELECTRONIC EVIDENCE ,2011,0,0,0,0,0,0,COMPUTER
SIKKIM,DESTRUCTION OF ELECTRONIC EVIDENCE ,2011,0,0,0,0,0,0,COMPUTER
TAMIL NADU,DESTRUCTION OF ELECTRONIC EVIDENCE ,2011,0,0,0,0,0,0,COMPUTER
TRIPURA,DESTRUCTION OF ELECTRONIC EVIDENCE ,2011,0,0,0,0,0,0,COMPUTER
UTTAR PRADESH,DESTRUCTION OF ELECTRONIC EVIDENCE ,2011,0,0,0,0,0,0,COMPUTER
UTTARAKHAND,DESTRUCTION OF ELECTRONIC EVIDENCE ,2011,0,0,0,0,0,0,COMPUTER
WEST BENGAL,DESTRUCTION OF ELECTRONIC EVIDENCE ,2011,0,0,0,0,0,0,COMPUTER
TOTAL-STATES,DESTRUCTION OF ELECTRONIC EVIDENCE ,2011,0,4,2,4,0,10,COMPUTER
A & N ISLANDS,DESTRUCTION OF ELECTRONIC EVIDENCE ,2011,0,0,0,0,0,0,COMPUTER
CHANDIGARH,DESTRUCTION OF ELECTRONIC EVIDENCE ,2011,0,0,0,0,0,0,COMPUTER
D & N HAVELI,DESTRUCTION OF ELECTRONIC EVIDENCE ,2011,0,0,0,0,0,0,COMPUTER
DAMAN & DIU,DESTRUCTION OF ELECTRONIC EVIDENCE ,2011,0,0,0,0,0,0,COMPUTER
DELHI,DESTRUCTION OF ELECTRONIC EVIDENCE ,2011,0,0,0,0,0,0,COMPUTER
LAKSHADWEEP,DESTRUCTION OF ELECTRONIC EVIDENCE ,2011,0,0,0,0,0,0,COMPUTER
PUDUCHERRY,DESTRUCTION OF ELECTRONIC EVIDENCE ,2011,0,0,0,0,0,0,COMPUTER
TOTAL-UTs,DESTRUCTION OF ELECTRONIC EVIDENCE ,2011,0,0,0,0,0,0,COMPUTER
TOTAL-INDIA,DESTRUCTION OF ELECTRONIC EVIDENCE ,2011,0,4,2,4,0,10,COMPUTER
ANDHRA PRADESH,FORGERY ,2011,0,0,1,0,0,1,COMPUTER
ARUNACHAL PRADESH,FORGERY ,2011,0,0,0,0,0,0,COMPUTER
ASSAM,FORGERY ,2011,0,0,0,0,0,0,COMPUTER
BIHAR,FORGERY ,2011,0,2,0,0,0,2,COMPUTER
CHHATTISGARH,FORGERY ,2011,12,32,28,13,5,90,COMPUTER
GOA,FORGERY ,2011,0,0,2,0,0,2,COMPUTER
GUJARAT,FORGERY ,2011,0,0,3,0,0,3,COMPUTER
HARYANA,FORGERY ,2011,0,0,0,0,0,0,COMPUTER
HIMACHAL PRADESH,FORGERY ,2011,0,0,0,0,0,0,COMPUTER
JAMMU & KASHMIR,FORGERY ,2011,0,0,0,0,0,0,COMPUTER
JHARKHAND,FORGERY ,2011,0,18,11,1,0,30,COMPUTER
KARNATAKA,FORGERY ,2011,0,1,0,0,0,1,COMPUTER
KERALA,FORGERY ,2011,0,0,3,0,0,3,COMPUTER
MADHYA PRADESH,FORGERY ,2011,0,3,0,0,0,3,COMPUTER
MAHARASHTRA,FORGERY ,2011,0,39,17,6,0,62,COMPUTER
MANIPUR,FORGERY ,2011,0,0,0,0,0,0,COMPUTER
MEGHALAYA,FORGERY ,2011,0,0,0,0,0,0,COMPUTER
MIZORAM,FORGERY ,2011,0,0,0,0,0,0,COMPUTER
NAGALAND,FORGERY ,2011,0,0,0,0,0,0,COMPUTER
ORISSA,FORGERY ,2011,0,0,0,0,0,0,COMPUTER
PUNJAB,FORGERY ,2011,0,10,7,4,0,21,COMPUTER
RAJASTHAN,FORGERY ,2011,0,4,4,0,0,8,COMPUTER
SIKKIM,FORGERY ,2011,0,0,0,0,0,0,COMPUTER
TAMIL NADU,FORGERY ,2011,0,0,1,6,0,7,COMPUTER
TRIPURA,FORGERY ,2011,0,0,0,0,0,0,COMPUTER
UTTAR PRADESH,FORGERY ,2011,0,8,9,0,0,17,COMPUTER
UTTARAKHAND,FORGERY ,2011,0,0,0,0,0,0,COMPUTER
WEST BENGAL,FORGERY ,2011,0,9,4,3,0,16,COMPUTER
TOTAL-STATES,FORGERY ,2011,12,126,90,33,5,266,COMPUTER
A & N ISLANDS,FORGERY ,2011,0,0,0,0,0,0,COMPUTER
CHANDIGARH,FORGERY ,2011,0,0,0,0,0,0,COMPUTER
D & N HAVELI,FORGERY ,2011,0,0,0,0,0,0,COMPUTER
DAMAN & DIU,FORGERY ,2011,0,0,0,0,0,0,COMPUTER
DELHI,FORGERY ,2011,0,3,7,0,1,11,COMPUTER
LAKSHADWEEP,FORGERY ,2011,0,0,0,0,0,0,COMPUTER
PUDUCHERRY,FORGERY ,2011,0,0,0,0,0,0,COMPUTER
TOTAL-UTs,FORGERY ,2011,0,3,7,0,1,11,COMPUTER
TOTAL-INDIA,FORGERY ,2011,12,129,97,33,6,277,COMPUTER
ANDHRA PRADESH,CRIMINAL BREACH OF TRUST ,2011,3,8,11,1,1,24,COMPUTER
ARUNACHAL PRADESH,CRIMINAL BREACH OF TRUST ,2011,0,0,0,0,0,0,COMPUTER
ASSAM,CRIMINAL BREACH OF TRUST ,2011,0,0,0,0,0,0,COMPUTER
BIHAR,CRIMINAL BREACH OF TRUST ,2011,0,0,0,0,0,0,COMPUTER
CHHATTISGARH,CRIMINAL BREACH OF TRUST ,2011,0,5,0,0,0,5,COMPUTER
GOA,CRIMINAL BREACH OF TRUST ,2011,0,0,0,0,0,0,COMPUTER
GUJARAT,CRIMINAL BREACH OF TRUST ,2011,0,2,3,1,1,7,COMPUTER
HARYANA,CRIMINAL BREACH OF TRUST ,2011,0,0,0,1,0,1,COMPUTER
HIMACHAL PRADESH,CRIMINAL BREACH OF TRUST ,2011,0,0,0,0,0,0,COMPUTER
JAMMU & KASHMIR,CRIMINAL BREACH OF TRUST ,2011,0,0,0,0,0,0,COMPUTER
JHARKHAND,CRIMINAL BREACH OF TRUST ,2011,0,3,8,2,0,13,COMPUTER
KARNATAKA,CRIMINAL BREACH OF TRUST ,2011,0,2,0,0,0,2,COMPUTER
KERALA,CRIMINAL BREACH OF TRUST ,2011,0,0,2,0,0,2,COMPUTER
MADHYA PRADESH,CRIMINAL BREACH OF TRUST ,2011,0,0,2,0,0,2,COMPUTER
MAHARASHTRA,CRIMINAL BREACH OF TRUST ,2011,0,4,13,3,0,20,COMPUTER
MANIPUR,CRIMINAL BREACH OF TRUST ,2011,0,0,0,0,0,0,COMPUTER
MEGHALAYA,CRIMINAL BREACH OF TRUST ,2011,0,0,0,0,0,0,COMPUTER
MIZORAM,CRIMINAL BREACH OF TRUST ,2011,0,0,0,0,0,0,COMPUTER
NAGALAND,CRIMINAL BREACH OF TRUST ,2011,0,0,0,0,0,0,COMPUTER
ORISSA,CRIMINAL BREACH OF TRUST ,2011,0,0,1,0,0,1,COMPUTER
PUNJAB,CRIMINAL BREACH OF TRUST ,2011,0,0,0,0,0,0,COMPUTER
RAJASTHAN,CRIMINAL BREACH OF TRUST ,2011,0,2,6,0,0,8,COMPUTER
SIKKIM,CRIMINAL BREACH OF TRUST ,2011,0,0,0,0,0,0,COMPUTER
TAMIL NADU,CRIMINAL BREACH OF TRUST ,2011,0,3,1,0,0,4,COMPUTER
TRIPURA,CRIMINAL BREACH OF TRUST ,2011,0,0,0,0,0,0,COMPUTER
UTTAR PRADESH,CRIMINAL BREACH OF TRUST ,2011,0,7,7,5,0,19,COMPUTER
UTTARAKHAND,CRIMINAL BREACH OF TRUST ,2011,0,0,0,0,0,0,COMPUTER
WEST BENGAL,CRIMINAL BREACH OF TRUST ,2011,0,0,0,0,0,0,COMPUTER
TOTAL-STATES,CRIMINAL BREACH OF TRUST ,2011,3,36,54,13,2,108,COMPUTER
A & N ISLANDS,CRIMINAL BREACH OF TRUST ,2011,0,0,0,0,0,0,COMPUTER
CHANDIGARH,CRIMINAL BREACH OF TRUST ,2011,0,0,0,0,0,0,COMPUTER
D & N HAVELI,CRIMINAL BREACH OF TRUST ,2011,0,0,0,0,0,0,COMPUTER
DAMAN & DIU,CRIMINAL BREACH OF TRUST ,2011,0,0,0,0,0,0,COMPUTER
DELHI,CRIMINAL BREACH OF TRUST ,2011,0,4,11,6,0,21,COMPUTER
LAKSHADWEEP,CRIMINAL BREACH OF TRUST ,2011,0,0,0,0,0,0,COMPUTER
PUDUCHERRY,CRIMINAL BREACH OF TRUST ,2011,0,0,0,0,0,0,COMPUTER
TOTAL-UTs,CRIMINAL BREACH OF TRUST ,2011,0,4,11,6,0,21,COMPUTER
TOTAL-INDIA,CRIMINAL BREACH OF TRUST ,2011,3,40,65,19,2,129,COMPUTER
ANDHRA PRADESH,COUNTERFEITING-PROPERTY ,2011,0,0,0,0,0,0,COMPUTER
ARUNACHAL PRADESH,COUNTERFEITING-PROPERTY ,2011,0,0,0,0,0,0,COMPUTER
ASSAM,COUNTERFEITING-PROPERTY ,2011,0,0,0,0,0,0,COMPUTER
BIHAR,COUNTERFEITING-PROPERTY ,2011,0,0,0,0,0,0,COMPUTER
CHHATTISGARH,COUNTERFEITING-PROPERTY ,2011,0,0,0,0,0,0,COMPUTER
GOA,COUNTERFEITING-PROPERTY ,2011,0,0,0,0,0,0,COMPUTER
GUJARAT,COUNTERFEITING-PROPERTY ,2011,0,1,0,0,0,1,COMPUTER
HARYANA,COUNTERFEITING-PROPERTY ,2011,0,0,0,0,0,0,COMPUTER
HIMACHAL PRADESH,COUNTERFEITING-PROPERTY ,2011,0,0,0,0,0,0,COMPUTER
JAMMU & KASHMIR,COUNTERFEITING-PROPERTY ,2011,0,0,0,0,0,0,COMPUTER
JHARKHAND,COUNTERFEITING-PROPERTY ,2011,0,0,0,0,0,0,COMPUTER
KARNATAKA,COUNTERFEITING-PROPERTY ,2011,0,0,0,0,0,0,COMPUTER
KERALA,COUNTERFEITING-PROPERTY ,2011,0,0,0,0,0,0,COMPUTER
MADHYA PRADESH,COUNTERFEITING-PROPERTY ,2011,0,0,0,0,0,0,COMPUTER
MAHARASHTRA,COUNTERFEITING-PROPERTY ,2011,0,0,0,0,0,0,COMPUTER
MANIPUR,COUNTERFEITING-PROPERTY ,2011,0,0,0,0,0,0,COMPUTER
MEGHALAYA,COUNTERFEITING-PROPERTY ,2011,0,0,0,0,0,0,COMPUTER
MIZORAM,COUNTERFEITING-PROPERTY ,2011,0,0,0,0,0,0,COMPUTER
NAGALAND,COUNTERFEITING-PROPERTY ,2011,0,0,0,0,0,0,COMPUTER
ORISSA,COUNTERFEITING-PROPERTY ,2011,0,0,0,0,0,0,COMPUTER
PUNJAB,COUNTERFEITING-PROPERTY ,2011,0,0,0,0,0,0,COMPUTER
RAJASTHAN,COUNTERFEITING-PROPERTY ,2011,0,0,6,0,0,6,COMPUTER
SIKKIM,COUNTERFEITING-PROPERTY ,2011,0,0,0,0,0,0,COMPUTER
TAMIL NADU,COUNTERFEITING-PROPERTY ,2011,0,0,0,0,0,0,COMPUTER
TRIPURA,COUNTERFEITING-PROPERTY ,2011,0,0,0,0,0,0,COMPUTER
UTTAR PRADESH,COUNTERFEITING-PROPERTY ,2011,0,0,0,0,0,0,COMPUTER
UTTARAKHAND,COUNTERFEITING-PROPERTY ,2011,0,0,0,0,0,0,COMPUTER
WEST BENGAL,COUNTERFEITING-PROPERTY ,2011,0,0,0,0,0,0,COMPUTER
TOTAL-STATES,COUNTERFEITING-PROPERTY ,2011,0,1,6,0,0,7,COMPUTER
A & N ISLANDS,COUNTERFEITING-PROPERTY ,2011,0,0,0,0,0,0,COMPUTER
CHANDIGARH,COUNTERFEITING-PROPERTY ,2011,0,0,0,0,0,0,COMPUTER
D & N HAVELI,COUNTERFEITING-PROPERTY ,2011,0,1,0,0,0,1,COMPUTER
DAMAN & DIU,COUNTERFEITING-PROPERTY ,2011,0,0,0,0,0,0,COMPUTER
DELHI,COUNTERFEITING-PROPERTY ,2011,0,0,0,0,0,0,COMPUTER
LAKSHADWEEP,COUNTERFEITING-PROPERTY ,2011,0,0,0,0,0,0,COMPUTER
PUDUCHERRY,COUNTERFEITING-PROPERTY ,2011,0,0,0,0,0,0,COMPUTER
TOTAL-UTs,COUNTERFEITING-PROPERTY ,2011,0,1,0,0,0,1,COMPUTER
TOTAL-INDIA,COUNTERFEITING-PROPERTY ,2011,0,2,6,0,0,8,COMPUTER
ANDHRA PRADESH,COUNTERFEITING-TAMPERING ,2011,0,0,0,0,0,0,COMPUTER
ARUNACHAL PRADESH,COUNTERFEITING-TAMPERING ,2011,0,0,0,0,0,0,COMPUTER
ASSAM,COUNTERFEITING-TAMPERING ,2011,0,0,0,0,0,0,COMPUTER
BIHAR,COUNTERFEITING-TAMPERING ,2011,0,0,0,0,0,0,COMPUTER
CHHATTISGARH,COUNTERFEITING-TAMPERING ,2011,1,4,2,0,0,7,COMPUTER
GOA,COUNTERFEITING-TAMPERING ,2011,0,0,0,0,0,0,COMPUTER
GUJARAT,COUNTERFEITING-TAMPERING ,2011,0,0,0,0,0,0,COMPUTER
HARYANA,COUNTERFEITING-TAMPERING ,2011,0,0,0,0,0,0,COMPUTER
HIMACHAL PRADESH,COUNTERFEITING-TAMPERING ,2011,0,0,0,0,0,0,COMPUTER
JAMMU & KASHMIR,COUNTERFEITING-TAMPERING ,2011,0,0,0,0,0,0,COMPUTER
JHARKHAND,COUNTERFEITING-TAMPERING ,2011,0,0,0,0,0,0,COMPUTER
KARNATAKA,COUNTERFEITING-TAMPERING ,2011,0,0,0,0,0,0,COMPUTER
KERALA,COUNTERFEITING-TAMPERING ,2011,0,0,0,0,0,0,COMPUTER
MADHYA PRADESH,COUNTERFEITING-TAMPERING ,2011,0,0,0,0,0,0,COMPUTER
MAHARASHTRA,COUNTERFEITING-TAMPERING ,2011,0,0,0,0,0,0,COMPUTER
MANIPUR,COUNTERFEITING-TAMPERING ,2011,0,0,0,0,0,0,COMPUTER
MEGHALAYA,COUNTERFEITING-TAMPERING ,2011,0,0,0,0,0,0,COMPUTER
MIZORAM,COUNTERFEITING-TAMPERING ,2011,0,0,0,0,0,0,COMPUTER
NAGALAND,COUNTERFEITING-TAMPERING ,2011,0,0,0,0,0,0,COMPUTER
ORISSA,COUNTERFEITING-TAMPERING ,2011,0,0,0,0,0,0,COMPUTER
PUNJAB,COUNTERFEITING-TAMPERING ,2011,0,0,0,0,0,0,COMPUTER
RAJASTHAN,COUNTERFEITING-TAMPERING ,2011,0,0,0,0,0,0,COMPUTER
SIKKIM,COUNTERFEITING-TAMPERING ,2011,0,0,0,0,0,0,COMPUTER
TAMIL NADU,COUNTERFEITING-TAMPERING ,2011,0,0,0,0,0,0,COMPUTER
TRIPURA,COUNTERFEITING-TAMPERING ,2011,0,0,0,0,0,0,COMPUTER
UTTAR PRADESH,COUNTERFEITING-TAMPERING ,2011,0,0,0,0,0,0,COMPUTER
UTTARAKHAND,COUNTERFEITING-TAMPERING ,2011,0,0,0,0,0,0,COMPUTER
WEST BENGAL,COUNTERFEITING-TAMPERING ,2011,0,0,0,0,0,0,COMPUTER
TOTAL-STATES,COUNTERFEITING-TAMPERING ,2011,1,4,2,0,0,7,COMPUTER
A & N ISLANDS,COUNTERFEITING-TAMPERING ,2011,0,0,0,0,0,0,COMPUTER
CHANDIGARH,COUNTERFEITING-TAMPERING ,2011,0,0,0,0,0,0,COMPUTER
D & N HAVELI,COUNTERFEITING-TAMPERING ,2011,0,0,0,0,0,0,COMPUTER
DAMAN & DIU,COUNTERFEITING-TAMPERING ,2011,0,0,0,0,0,0,COMPUTER
DELHI,COUNTERFEITING-TAMPERING ,2011,0,0,0,0,0,0,COMPUTER
LAKSHADWEEP,COUNTERFEITING-TAMPERING ,2011,0,0,0,0,0,0,COMPUTER
PUDUCHERRY,COUNTERFEITING-TAMPERING ,2011,0,0,0,0,0,0,COMPUTER
TOTAL-UTs,COUNTERFEITING-TAMPERING ,2011,0,0,0,0,0,0,COMPUTER
TOTAL-INDIA,COUNTERFEITING-TAMPERING ,2011,1,4,2,0,0,7,COMPUTER
ANDHRA PRADESH,COUNTERFEITING-CURRENCY,2011,0,0,0,0,0,0,COMPUTER
ARUNACHAL PRADESH,COUNTERFEITING-CURRENCY,2011,0,0,0,0,0,0,COMPUTER
ASSAM,COUNTERFEITING-CURRENCY,2011,0,0,0,0,0,0,COMPUTER
BIHAR,COUNTERFEITING-CURRENCY,2011,0,0,0,0,0,0,COMPUTER
CHHATTISGARH,COUNTERFEITING-CURRENCY,2011,0,0,0,0,0,0,COMPUTER
GOA,COUNTERFEITING-CURRENCY,2011,0,0,0,0,0,0,COMPUTER
GUJARAT,COUNTERFEITING-CURRENCY,2011,0,0,0,0,0,0,COMPUTER
HARYANA,COUNTERFEITING-CURRENCY,2011,0,4,3,0,0,7,COMPUTER
HIMACHAL PRADESH,COUNTERFEITING-CURRENCY,2011,0,0,0,0,0,0,COMPUTER
JAMMU & KASHMIR,COUNTERFEITING-CURRENCY,2011,0,0,0,0,0,0,COMPUTER
JHARKHAND,COUNTERFEITING-CURRENCY,2011,0,0,0,0,0,0,COMPUTER
KARNATAKA,COUNTERFEITING-CURRENCY,2011,0,0,0,0,0,0,COMPUTER
KERALA,COUNTERFEITING-CURRENCY,2011,0,0,0,0,0,0,COMPUTER
MADHYA PRADESH,COUNTERFEITING-CURRENCY,2011,0,0,0,0,0,0,COMPUTER
MAHARASHTRA,COUNTERFEITING-CURRENCY,2011,0,0,0,0,0,0,COMPUTER
MANIPUR,COUNTERFEITING-CURRENCY,2011,0,0,0,0,0,0,COMPUTER
MEGHALAYA,COUNTERFEITING-CURRENCY,2011,0,0,0,0,0,0,COMPUTER
MIZORAM,COUNTERFEITING-CURRENCY,2011,0,0,0,0,0,0,COMPUTER
NAGALAND,COUNTERFEITING-CURRENCY,2011,0,0,0,0,0,0,COMPUTER
ORISSA,COUNTERFEITING-CURRENCY,2011,0,0,0,0,0,0,COMPUTER
PUNJAB,COUNTERFEITING-CURRENCY,2011,0,0,0,0,0,0,COMPUTER
RAJASTHAN,COUNTERFEITING-CURRENCY,2011,0,0,0,0,0,0,COMPUTER
SIKKIM,COUNTERFEITING-CURRENCY,2011,0,0,0,0,0,0,COMPUTER
TAMIL NADU,COUNTERFEITING-CURRENCY,2011,0,0,0,0,0,0,COMPUTER
TRIPURA,COUNTERFEITING-CURRENCY,2011,0,0,0,0,0,0,COMPUTER
UTTAR PRADESH,COUNTERFEITING-CURRENCY,2011,0,0,0,0,0,0,COMPUTER
UTTARAKHAND,COUNTERFEITING-CURRENCY,2011,0,0,0,0,0,0,COMPUTER
WEST BENGAL,COUNTERFEITING-CURRENCY,2011,0,0,0,0,0,0,COMPUTER
TOTAL-STATES,COUNTERFEITING-CURRENCY,2011,0,4,3,0,0,7,COMPUTER
A & N ISLANDS,COUNTERFEITING-CURRENCY,2011,0,0,0,0,0,0,COMPUTER
CHANDIGARH,COUNTERFEITING-CURRENCY,2011,0,0,0,0,0,0,COMPUTER
D & N HAVELI,COUNTERFEITING-CURRENCY,2011,0,0,0,0,0,0,COMPUTER
DAMAN & DIU,COUNTERFEITING-CURRENCY,2011,0,0,0,0,0,0,COMPUTER
DELHI,COUNTERFEITING-CURRENCY,2011,0,1,3,0,0,4,COMPUTER
LAKSHADWEEP,COUNTERFEITING-CURRENCY,2011,0,0,0,0,0,0,COMPUTER
PUDUCHERRY,COUNTERFEITING-CURRENCY,2011,0,0,0,0,0,0,COMPUTER
TOTAL-UTs,COUNTERFEITING-CURRENCY,2011,0,1,3,0,0,4,COMPUTER
TOTAL-INDIA,COUNTERFEITING-CURRENCY,2011,0,5,6,0,0,11,COMPUTER
ANDHRA PRADESH,CYBER-CRIME,2011,3,8,12,1,1,25,COMPUTER
ARUNACHAL PRADESH,CYBER-CRIME,2011,0,0,0,0,0,0,COMPUTER
ASSAM,CYBER-CRIME,2011,0,0,0,0,0,0,COMPUTER
BIHAR,CYBER-CRIME,2011,0,2,0,0,0,2,COMPUTER
CHHATTISGARH,CYBER-CRIME,2011,13,41,30,13,5,102,COMPUTER
GOA,CYBER-CRIME,2011,0,0,2,0,0,2,COMPUTER
GUJARAT,CYBER-CRIME,2011,0,5,8,5,1,19,COMPUTER
HARYANA,CYBER-CRIME,2011,0,4,3,1,0,8,COMPUTER
HIMACHAL PRADESH,CYBER-CRIME,2011,0,0,0,0,0,0,COMPUTER
JAMMU & KASHMIR,CYBER-CRIME,2011,0,0,0,0,0,0,COMPUTER
JHARKHAND,CYBER-CRIME,2011,0,21,19,3,0,43,COMPUTER
KARNATAKA,CYBER-CRIME,2011,0,5,0,0,0,5,COMPUTER
KERALA,CYBER-CRIME,2011,0,0,5,0,0,5,COMPUTER
MADHYA PRADESH,CYBER-CRIME,2011,0,4,2,0,0,6,COMPUTER
MAHARASHTRA,CYBER-CRIME,2011,0,46,30,9,0,85,COMPUTER
MANIPUR,CYBER-CRIME,2011,0,0,0,0,0,0,COMPUTER
MEGHALAYA,CYBER-CRIME,2011,0,0,0,0,0,0,COMPUTER
MIZORAM,CYBER-CRIME,2011,0,0,0,0,0,0,COMPUTER
NAGALAND,CYBER-CRIME,2011,0,0,0,0,0,0,COMPUTER
ORISSA,CYBER-CRIME,2011,0,0,1,0,0,1,COMPUTER
PUNJAB,CYBER-CRIME,2011,0,10,7,4,0,21,COMPUTER
RAJASTHAN,CYBER-CRIME,2011,0,6,16,0,0,22,COMPUTER
SIKKIM,CYBER-CRIME,2011,0,0,0,0,0,0,COMPUTER
TAMIL NADU,CYBER-CRIME,2011,0,3,2,6,0,11,COMPUTER
TRIPURA,CYBER-CRIME,2011,0,0,0,0,0,0,COMPUTER
UTTAR PRADESH,CYBER-CRIME,2011,0,15,16,5,0,36,COMPUTER
UTTARAKHAND,CYBER-CRIME,2011,0,0,0,0,0,0,COMPUTER
WEST BENGAL,CYBER-CRIME,2011,0,9,4,3,0,16,COMPUTER
TOTAL-STATES,CYBER-CRIME,2011,16,179,157,50,7,409,COMPUTER
A & N ISLANDS,CYBER-CRIME,2011,0,0,0,0,0,0,COMPUTER
CHANDIGARH,CYBER-CRIME,2011,0,0,0,0,0,0,COMPUTER
D & N HAVELI,CYBER-CRIME,2011,0,1,0,0,0,1,COMPUTER
DAMAN & DIU,CYBER-CRIME,2011,0,0,0,0,0,0,COMPUTER
DELHI,CYBER-CRIME,2011,0,8,21,6,1,36,COMPUTER
LAKSHADWEEP,CYBER-CRIME,2011,0,0,0,0,0,0,COMPUTER
PUDUCHERRY,CYBER-CRIME,2011,0,0,0,0,0,0,COMPUTER
TOTAL-UTs,CYBER-CRIME,2011,0,9,21,6,1,37,COMPUTER
TOTAL-INDIA,CYBER-CRIME,2011,16,188,178,56,8,446,COMPUTER
ANDHRA PRADESH,TAMPERING DOCUMENTS,2012,0,1,4,0,0,5,COMPUTER
ARUNACHAL PRADESH,TAMPERING DOCUMENTS,2012,0,0,0,0,0,0,COMPUTER
ASSAM,TAMPERING DOCUMENTS,2012,0,0,0,0,0,0,COMPUTER
BIHAR,TAMPERING DOCUMENTS,2012,0,0,0,0,0,0,COMPUTER
CHHATTISGARH,TAMPERING DOCUMENTS,2012,0,0,0,0,0,0,COMPUTER
GOA,TAMPERING DOCUMENTS,2012,0,0,1,0,0,1,COMPUTER
GUJARAT,TAMPERING DOCUMENTS,2012,0,10,9,3,0,22,COMPUTER
HARYANA,TAMPERING DOCUMENTS,2012,0,0,0,0,0,0,COMPUTER
HIMACHAL PRADESH,TAMPERING DOCUMENTS,2012,0,1,0,0,0,1,COMPUTER
JAMMU & KASHMIR,TAMPERING DOCUMENTS,2012,0,0,0,0,0,0,COMPUTER
JHARKHAND,TAMPERING DOCUMENTS,2012,0,1,0,0,0,1,COMPUTER
KARNATAKA,TAMPERING DOCUMENTS,2012,0,0,0,0,0,0,COMPUTER
KERALA,TAMPERING DOCUMENTS,2012,0,0,1,0,0,1,COMPUTER
MADHYA PRADESH,TAMPERING DOCUMENTS,2012,0,7,3,0,0,10,COMPUTER
MAHARASHTRA,TAMPERING DOCUMENTS,2012,0,8,4,0,1,13,COMPUTER
MANIPUR,TAMPERING DOCUMENTS,2012,0,0,0,0,0,0,COMPUTER
MEGHALAYA,TAMPERING DOCUMENTS,2012,0,0,0,0,0,0,COMPUTER
MIZORAM,TAMPERING DOCUMENTS,2012,0,0,0,0,0,0,COMPUTER
NAGALAND,TAMPERING DOCUMENTS,2012,0,0,0,0,0,0,COMPUTER
ORISSA,TAMPERING DOCUMENTS,2012,0,0,0,0,0,0,COMPUTER
PUNJAB,TAMPERING DOCUMENTS,2012,0,22,8,0,0,30,COMPUTER
RAJASTHAN,TAMPERING DOCUMENTS,2012,0,4,0,0,0,4,COMPUTER
SIKKIM,TAMPERING DOCUMENTS,2012,0,0,0,0,0,0,COMPUTER
TAMIL NADU,TAMPERING DOCUMENTS,2012,0,0,0,0,0,0,COMPUTER
TRIPURA,TAMPERING DOCUMENTS,2012,0,0,0,0,0,0,COMPUTER
UTTAR PRADESH,TAMPERING DOCUMENTS,2012,0,6,4,0,0,10,COMPUTER
UTTARAKHAND,TAMPERING DOCUMENTS,2012,0,2,0,0,0,2,COMPUTER
WEST BENGAL,TAMPERING DOCUMENTS,2012,0,2,2,0,0,4,COMPUTER
TOTAL-STATES,TAMPERING DOCUMENTS,2012,0,64,36,3,1,104,COMPUTER
A & N ISLANDS,TAMPERING DOCUMENTS,2012,0,0,0,0,0,0,COMPUTER
CHANDIGARH,TAMPERING DOCUMENTS,2012,0,0,0,0,0,0,COMPUTER
D & N HAVELI,TAMPERING DOCUMENTS,2012,0,0,0,0,0,0,COMPUTER
DAMAN & DIU,TAMPERING DOCUMENTS,2012,0,0,0,0,0,0,COMPUTER
DELHI,TAMPERING DOCUMENTS,2012,0,0,0,0,0,0,COMPUTER
LAKSHADWEEP,TAMPERING DOCUMENTS,2012,0,0,0,0,0,0,COMPUTER
PUDUCHERRY,TAMPERING DOCUMENTS,2012,0,0,0,0,0,0,COMPUTER
TOTAL-UTs,TAMPERING DOCUMENTS,2012,0,0,0,0,0,0,COMPUTER
TOTAL-INDIA,TAMPERING DOCUMENTS,2012,0,64,36,3,1,104,COMPUTER
ANDHRA PRADESH,LOSS OR DAMAGE,2012,0,83,29,6,0,118,COMPUTER
ARUNACHAL PRADESH,LOSS OR DAMAGE,2012,0,0,2,3,0,5,COMPUTER
ASSAM,LOSS OR DAMAGE,2012,0,5,0,0,0,5,COMPUTER
BIHAR,LOSS OR DAMAGE,2012,0,0,0,0,0,0,COMPUTER
CHHATTISGARH,LOSS OR DAMAGE,2012,3,12,0,0,0,15,COMPUTER
GOA,LOSS OR DAMAGE,2012,0,0,0,0,0,0,COMPUTER
GUJARAT,LOSS OR DAMAGE,2012,0,15,6,0,0,21,COMPUTER
HARYANA,LOSS OR DAMAGE,2012,0,6,9,1,0,16,COMPUTER
HIMACHAL PRADESH,LOSS OR DAMAGE,2012,1,3,0,0,0,4,COMPUTER
JAMMU & KASHMIR,LOSS OR DAMAGE,2012,0,5,3,0,0,8,COMPUTER
JHARKHAND,LOSS OR DAMAGE,2012,0,1,0,0,0,1,COMPUTER
KARNATAKA,LOSS OR DAMAGE,2012,1,10,8,0,0,19,COMPUTER
KERALA,LOSS OR DAMAGE,2012,0,20,8,6,0,34,COMPUTER
MADHYA PRADESH,LOSS OR DAMAGE,2012,4,50,15,0,0,69,COMPUTER
MAHARASHTRA,LOSS OR DAMAGE,2012,1,65,18,5,0,89,COMPUTER
MANIPUR,LOSS OR DAMAGE,2012,0,0,0,0,0,0,COMPUTER
MEGHALAYA,LOSS OR DAMAGE,2012,0,0,0,0,0,0,COMPUTER
MIZORAM,LOSS OR DAMAGE,2012,0,0,0,0,0,0,COMPUTER
NAGALAND,LOSS OR DAMAGE,2012,0,0,0,0,0,0,COMPUTER
ORISSA,LOSS OR DAMAGE,2012,0,0,0,0,0,0,COMPUTER
PUNJAB,LOSS OR DAMAGE,2012,0,0,13,0,0,13,COMPUTER
RAJASTHAN,LOSS OR DAMAGE,2012,11,31,10,2,0,54,COMPUTER
SIKKIM,LOSS OR DAMAGE,2012,0,0,0,0,0,0,COMPUTER
TAMIL NADU,LOSS OR DAMAGE,2012,0,19,8,3,1,31,COMPUTER
TRIPURA,LOSS OR DAMAGE,2012,0,4,1,0,0,5,COMPUTER
UTTAR PRADESH,LOSS OR DAMAGE,2012,0,21,23,3,1,48,COMPUTER
UTTARAKHAND,LOSS OR DAMAGE,2012,0,0,0,0,0,0,COMPUTER
WEST BENGAL,LOSS OR DAMAGE,2012,0,21,11,4,0,36,COMPUTER
TOTAL-STATES,LOSS OR DAMAGE,2012,21,371,164,33,2,591,COMPUTER
A & N ISLANDS,LOSS OR DAMAGE,2012,0,0,0,0,0,0,COMPUTER
CHANDIGARH,LOSS OR DAMAGE,2012,0,3,2,0,0,5,COMPUTER
D & N HAVELI,LOSS OR DAMAGE,2012,0,0,0,0,0,0,COMPUTER
DAMAN & DIU,LOSS OR DAMAGE,2012,0,0,0,0,0,0,COMPUTER
DELHI,LOSS OR DAMAGE,2012,0,7,5,0,0,12,COMPUTER
LAKSHADWEEP,LOSS OR DAMAGE,2012,0,0,0,0,0,0,COMPUTER
PUDUCHERRY,LOSS OR DAMAGE,2012,0,0,4,0,0,4,COMPUTER
TOTAL-UTs,LOSS OR DAMAGE,2012,0,10,11,0,0,21,COMPUTER
TOTAL-INDIA,LOSS OR DAMAGE,2012,21,381,175,33,2,612,COMPUTER
ANDHRA PRADESH,HACKING ,2012,0,27,1,0,0,28,COMPUTER
ARUNACHAL PRADESH,HACKING ,2012,0,0,0,0,0,0,COMPUTER
ASSAM,HACKING ,2012,0,0,0,0,0,0,COMPUTER
BIHAR,HACKING ,2012,0,12,2,0,0,14,COMPUTER
CHHATTISGARH,HACKING ,2012,1,5,0,0,0,6,COMPUTER
GOA,HACKING ,2012,0,0,3,0,0,3,COMPUTER
GUJARAT,HACKING ,2012,0,9,6,0,0,15,COMPUTER
HARYANA,HACKING ,2012,0,0,0,0,0,0,COMPUTER
HIMACHAL PRADESH,HACKING ,2012,0,0,0,0,0,0,COMPUTER
JAMMU & KASHMIR,HACKING ,2012,0,0,0,0,0,0,COMPUTER
JHARKHAND,HACKING ,2012,0,1,0,0,0,1,COMPUTER
KARNATAKA,HACKING ,2012,0,14,5,0,0,19,COMPUTER
KERALA,HACKING ,2012,1,3,3,0,0,7,COMPUTER
MADHYA PRADESH,HACKING ,2012,0,3,0,0,0,3,COMPUTER
MAHARASHTRA,HACKING ,2012,0,4,3,1,0,8,COMPUTER
MANIPUR,HACKING ,2012,0,0,0,0,0,0,COMPUTER
MEGHALAYA,HACKING ,2012,0,0,0,0,0,0,COMPUTER
MIZORAM,HACKING ,2012,0,0,0,0,0,0,COMPUTER
NAGALAND,HACKING ,2012,0,0,0,0,0,0,COMPUTER
ORISSA,HACKING ,2012,0,0,0,0,0,0,COMPUTER
PUNJAB,HACKING ,2012,0,0,5,1,0,6,COMPUTER
RAJASTHAN,HACKING ,2012,0,0,0,0,0,0,COMPUTER
SIKKIM,HACKING ,2012,0,0,0,0,0,0,COMPUTER
TAMIL NADU,HACKING ,2012,0,0,0,0,0,0,COMPUTER
TRIPURA,HACKING ,2012,0,0,0,0,0,0,COMPUTER
UTTAR PRADESH,HACKING ,2012,0,8,3,0,0,11,COMPUTER
UTTARAKHAND,HACKING ,2012,0,0,0,0,0,0,COMPUTER
WEST BENGAL,HACKING ,2012,0,4,0,0,0,4,COMPUTER
TOTAL-STATES,HACKING ,2012,2,90,31,2,0,125,COMPUTER
A & N ISLANDS,HACKING ,2012,0,0,0,0,0,0,COMPUTER
CHANDIGARH,HACKING ,2012,0,0,0,0,0,0,COMPUTER
D & N HAVELI,HACKING ,2012,0,0,0,0,0,0,COMPUTER
DAMAN & DIU,HACKING ,2012,0,0,0,0,0,0,COMPUTER
DELHI,HACKING ,2012,0,8,4,0,0,12,COMPUTER
LAKSHADWEEP,HACKING ,2012,0,0,0,0,0,0,COMPUTER
PUDUCHERRY,HACKING ,2012,0,0,0,0,0,0,COMPUTER
TOTAL-UTs,HACKING ,2012,0,8,4,0,0,12,COMPUTER
TOTAL-INDIA,HACKING ,2012,2,98,35,2,0,137,COMPUTER
ANDHRA PRADESH,TRANSMISSION IN ELECTRONIC FORM ,2012,0,10,1,4,0,15,COMPUTER
ARUNACHAL PRADESH,TRANSMISSION IN ELECTRONIC FORM ,2012,0,0,1,0,0,1,COMPUTER
ASSAM,TRANSMISSION IN ELECTRONIC FORM ,2012,0,0,0,0,0,0,COMPUTER
BIHAR,TRANSMISSION IN ELECTRONIC FORM ,2012,0,2,1,0,0,3,COMPUTER
CHHATTISGARH,TRANSMISSION IN ELECTRONIC FORM ,2012,0,8,2,0,0,10,COMPUTER
GOA,TRANSMISSION IN ELECTRONIC FORM ,2012,1,3,1,1,0,6,COMPUTER
GUJARAT,TRANSMISSION IN ELECTRONIC FORM ,2012,1,6,2,2,0,11,COMPUTER
HARYANA,TRANSMISSION IN ELECTRONIC FORM ,2012,0,6,3,0,0,9,COMPUTER
HIMACHAL PRADESH,TRANSMISSION IN ELECTRONIC FORM ,2012,2,15,1,2,0,20,COMPUTER
JAMMU & KASHMIR,TRANSMISSION IN ELECTRONIC FORM ,2012,0,4,3,0,0,7,COMPUTER
JHARKHAND,TRANSMISSION IN ELECTRONIC FORM ,2012,0,4,0,0,0,4,COMPUTER
KARNATAKA,TRANSMISSION IN ELECTRONIC FORM ,2012,1,8,7,4,0,20,COMPUTER
KERALA,TRANSMISSION IN ELECTRONIC FORM ,2012,14,52,30,4,0,100,COMPUTER
MADHYA PRADESH,TRANSMISSION IN ELECTRONIC FORM ,2012,9,40,14,2,0,65,COMPUTER
MAHARASHTRA,TRANSMISSION IN ELECTRONIC FORM ,2012,4,57,14,5,0,80,COMPUTER
MANIPUR,TRANSMISSION IN ELECTRONIC FORM ,2012,0,0,0,0,0,0,COMPUTER
MEGHALAYA,TRANSMISSION IN ELECTRONIC FORM ,2012,0,0,0,0,0,0,COMPUTER
MIZORAM,TRANSMISSION IN ELECTRONIC FORM ,2012,0,0,0,0,0,0,COMPUTER
NAGALAND,TRANSMISSION IN ELECTRONIC FORM ,2012,0,0,0,0,0,0,COMPUTER
ORISSA,TRANSMISSION IN ELECTRONIC FORM ,2012,0,0,1,0,0,1,COMPUTER
PUNJAB,TRANSMISSION IN ELECTRONIC FORM ,2012,0,0,29,7,0,36,COMPUTER
RAJASTHAN,TRANSMISSION IN ELECTRONIC FORM ,2012,2,20,8,2,0,32,COMPUTER
SIKKIM,TRANSMISSION IN ELECTRONIC FORM ,2012,0,0,0,0,0,0,COMPUTER
TAMIL NADU,TRANSMISSION IN ELECTRONIC FORM ,2012,1,1,0,0,0,2,COMPUTER
TRIPURA,TRANSMISSION IN ELECTRONIC FORM ,2012,0,3,2,0,0,5,COMPUTER
UTTAR PRADESH,TRANSMISSION IN ELECTRONIC FORM ,2012,0,24,17,0,0,41,COMPUTER
UTTARAKHAND,TRANSMISSION IN ELECTRONIC FORM ,2012,0,0,0,0,0,0,COMPUTER
WEST BENGAL,TRANSMISSION IN ELECTRONIC FORM ,2012,2,14,9,2,0,27,COMPUTER
TOTAL-STATES,TRANSMISSION IN ELECTRONIC FORM ,2012,37,277,146,35,0,495,COMPUTER
A & N ISLANDS,TRANSMISSION IN ELECTRONIC FORM ,2012,0,0,0,0,0,0,COMPUTER
CHANDIGARH,TRANSMISSION IN ELECTRONIC FORM ,2012,0,0,0,0,0,0,COMPUTER
D & N HAVELI,TRANSMISSION IN ELECTRONIC FORM ,2012,0,0,0,0,0,0,COMPUTER
DAMAN & DIU,TRANSMISSION IN ELECTRONIC FORM ,2012,0,0,0,0,0,0,COMPUTER
DELHI,TRANSMISSION IN ELECTRONIC FORM ,2012,0,1,1,0,0,2,COMPUTER
LAKSHADWEEP,TRANSMISSION IN ELECTRONIC FORM ,2012,0,0,0,0,0,0,COMPUTER
PUDUCHERRY,TRANSMISSION IN ELECTRONIC FORM ,2012,0,0,0,0,0,0,COMPUTER
TOTAL-UTs,TRANSMISSION IN ELECTRONIC FORM ,2012,0,1,1,0,0,2,COMPUTER
TOTAL-INDIA,TRANSMISSION IN ELECTRONIC FORM ,2012,37,278,147,35,0,497,COMPUTER
ANDHRA PRADESH,FAILURE - OF COMPLIANCE ,2012,0,0,0,0,0,0,COMPUTER
ARUNACHAL PRADESH,FAILURE - OF COMPLIANCE ,2012,0,0,0,0,0,0,COMPUTER
ASSAM,FAILURE - OF COMPLIANCE ,2012,0,0,0,0,0,0,COMPUTER
BIHAR,FAILURE - OF COMPLIANCE ,2012,0,0,0,0,0,0,COMPUTER
CHHATTISGARH,FAILURE - OF COMPLIANCE ,2012,0,0,0,0,0,0,COMPUTER
GOA,FAILURE - OF COMPLIANCE ,2012,0,0,0,0,0,0,COMPUTER
GUJARAT,FAILURE - OF COMPLIANCE ,2012,0,1,0,2,0,3,COMPUTER
HARYANA,FAILURE - OF COMPLIANCE ,2012,0,0,0,0,0,0,COMPUTER
HIMACHAL PRADESH,FAILURE - OF COMPLIANCE ,2012,0,0,0,0,0,0,COMPUTER
JAMMU & KASHMIR,FAILURE - OF COMPLIANCE ,2012,0,0,0,0,0,0,COMPUTER
JHARKHAND,FAILURE - OF COMPLIANCE ,2012,0,0,0,0,0,0,COMPUTER
KARNATAKA,FAILURE - OF COMPLIANCE ,2012,0,0,1,0,0,1,COMPUTER
KERALA,FAILURE - OF COMPLIANCE ,2012,0,0,0,0,0,0,COMPUTER
MADHYA PRADESH,FAILURE - OF COMPLIANCE ,2012,0,0,0,0,0,0,COMPUTER
MAHARASHTRA,FAILURE - OF COMPLIANCE ,2012,0,0,0,0,0,0,COMPUTER
MANIPUR,FAILURE - OF COMPLIANCE ,2012,0,0,0,0,0,0,COMPUTER
MEGHALAYA,FAILURE - OF COMPLIANCE ,2012,0,0,0,0,0,0,COMPUTER
MIZORAM,FAILURE - OF COMPLIANCE ,2012,0,0,0,0,0,0,COMPUTER
NAGALAND,FAILURE - OF COMPLIANCE ,2012,0,0,0,0,0,0,COMPUTER
ORISSA,FAILURE - OF COMPLIANCE ,2012,0,0,0,0,0,0,COMPUTER
PUNJAB,FAILURE - OF COMPLIANCE ,2012,0,0,0,0,0,0,COMPUTER
RAJASTHAN,FAILURE - OF COMPLIANCE ,2012,0,0,0,0,0,0,COMPUTER
SIKKIM,FAILURE - OF COMPLIANCE ,2012,0,0,0,0,0,0,COMPUTER
TAMIL NADU,FAILURE - OF COMPLIANCE ,2012,0,0,0,0,0,0,COMPUTER
TRIPURA,FAILURE - OF COMPLIANCE ,2012,0,0,0,0,0,0,COMPUTER
UTTAR PRADESH,FAILURE - OF COMPLIANCE ,2012,0,0,0,0,0,0,COMPUTER
UTTARAKHAND,FAILURE - OF COMPLIANCE ,2012,0,0,0,0,0,0,COMPUTER
WEST BENGAL,FAILURE - OF COMPLIANCE ,2012,0,0,0,0,0,0,COMPUTER
TOTAL-STATES,FAILURE - OF COMPLIANCE ,2012,0,1,1,2,0,4,COMPUTER
A & N ISLANDS,FAILURE - OF COMPLIANCE ,2012,0,0,0,0,0,0,COMPUTER
CHANDIGARH,FAILURE - OF COMPLIANCE ,2012,0,0,0,0,0,0,COMPUTER
D & N HAVELI,FAILURE - OF COMPLIANCE ,2012,0,0,0,0,0,0,COMPUTER
DAMAN & DIU,FAILURE - OF COMPLIANCE ,2012,0,0,0,0,0,0,COMPUTER
DELHI,FAILURE - OF COMPLIANCE ,2012,0,0,0,0,0,0,COMPUTER
LAKSHADWEEP,FAILURE - OF COMPLIANCE ,2012,0,0,0,0,0,0,COMPUTER
PUDUCHERRY,FAILURE - OF COMPLIANCE ,2012,0,0,0,0,0,0,COMPUTER
TOTAL-UTs,FAILURE - OF COMPLIANCE ,2012,0,0,0,0,0,0,COMPUTER
TOTAL-INDIA,FAILURE - OF COMPLIANCE ,2012,0,1,1,2,0,4,COMPUTER
ANDHRA PRADESH,FAILURE - TO ASSIST IN DECRYPTING THE INFORMATION INTERCEPTED BY GOVT AGENCY ,2012,0,0,0,0,0,0,COMPUTER
ARUNACHAL PRADESH,FAILURE - TO ASSIST IN DECRYPTING THE INFORMATION INTERCEPTED BY GOVT AGENCY ,2012,0,0,0,0,0,0,COMPUTER
ASSAM,FAILURE - TO ASSIST IN DECRYPTING THE INFORMATION INTERCEPTED BY GOVT AGENCY ,2012,0,0,0,0,0,0,COMPUTER
BIHAR,FAILURE - TO ASSIST IN DECRYPTING THE INFORMATION INTERCEPTED BY GOVT AGENCY ,2012,0,0,0,0,0,0,COMPUTER
CHHATTISGARH,FAILURE - TO ASSIST IN DECRYPTING THE INFORMATION INTERCEPTED BY GOVT AGENCY ,2012,0,0,0,0,0,0,COMPUTER
GOA,FAILURE - TO ASSIST IN DECRYPTING THE INFORMATION INTERCEPTED BY GOVT AGENCY ,2012,0,0,0,0,0,0,COMPUTER
GUJARAT,FAILURE - TO ASSIST IN DECRYPTING THE INFORMATION INTERCEPTED BY GOVT AGENCY ,2012,0,0,0,0,0,0,COMPUTER
HARYANA,FAILURE - TO ASSIST IN DECRYPTING THE INFORMATION INTERCEPTED BY GOVT AGENCY ,2012,0,0,0,0,0,0,COMPUTER
HIMACHAL PRADESH,FAILURE - TO ASSIST IN DECRYPTING THE INFORMATION INTERCEPTED BY GOVT AGENCY ,2012,0,0,0,0,0,0,COMPUTER
JAMMU & KASHMIR,FAILURE - TO ASSIST IN DECRYPTING THE INFORMATION INTERCEPTED BY GOVT AGENCY ,2012,0,0,0,0,0,0,COMPUTER
JHARKHAND,FAILURE - TO ASSIST IN DECRYPTING THE INFORMATION INTERCEPTED BY GOVT AGENCY ,2012,0,0,0,0,0,0,COMPUTER
KARNATAKA,FAILURE - TO ASSIST IN DECRYPTING THE INFORMATION INTERCEPTED BY GOVT AGENCY ,2012,0,0,0,0,0,0,COMPUTER
KERALA,FAILURE - TO ASSIST IN DECRYPTING THE INFORMATION INTERCEPTED BY GOVT AGENCY ,2012,0,1,0,0,0,1,COMPUTER
MADHYA PRADESH,FAILURE - TO ASSIST IN DECRYPTING THE INFORMATION INTERCEPTED BY GOVT AGENCY ,2012,0,1,0,0,0,1,COMPUTER
MAHARASHTRA,FAILURE - TO ASSIST IN DECRYPTING THE INFORMATION INTERCEPTED BY GOVT AGENCY ,2012,0,0,0,0,0,0,COMPUTER
MANIPUR,FAILURE - TO ASSIST IN DECRYPTING THE INFORMATION INTERCEPTED BY GOVT AGENCY ,2012,0,0,0,0,0,0,COMPUTER
MEGHALAYA,FAILURE - TO ASSIST IN DECRYPTING THE INFORMATION INTERCEPTED BY GOVT AGENCY ,2012,0,0,0,0,0,0,COMPUTER
MIZORAM,FAILURE - TO ASSIST IN DECRYPTING THE INFORMATION INTERCEPTED BY GOVT AGENCY ,2012,0,0,0,0,0,0,COMPUTER
NAGALAND,FAILURE - TO ASSIST IN DECRYPTING THE INFORMATION INTERCEPTED BY GOVT AGENCY ,2012,0,0,0,0,0,0,COMPUTER
ORISSA,FAILURE - TO ASSIST IN DECRYPTING THE INFORMATION INTERCEPTED BY GOVT AGENCY ,2012,0,0,0,0,0,0,COMPUTER
PUNJAB,FAILURE - TO ASSIST IN DECRYPTING THE INFORMATION INTERCEPTED BY GOVT AGENCY ,2012,0,0,0,0,0,0,COMPUTER
RAJASTHAN,FAILURE - TO ASSIST IN DECRYPTING THE INFORMATION INTERCEPTED BY GOVT AGENCY ,2012,0,0,0,0,0,0,COMPUTER
SIKKIM,FAILURE - TO ASSIST IN DECRYPTING THE INFORMATION INTERCEPTED BY GOVT AGENCY ,2012,0,0,0,0,0,0,COMPUTER
TAMIL NADU,FAILURE - TO ASSIST IN DECRYPTING THE INFORMATION INTERCEPTED BY GOVT AGENCY ,2012,0,0,0,0,0,0,COMPUTER
TRIPURA,FAILURE - TO ASSIST IN DECRYPTING THE INFORMATION INTERCEPTED BY GOVT AGENCY ,2012,0,0,0,0,0,0,COMPUTER
UTTAR PRADESH,FAILURE - TO ASSIST IN DECRYPTING THE INFORMATION INTERCEPTED BY GOVT AGENCY ,2012,0,0,0,0,0,0,COMPUTER
UTTARAKHAND,FAILURE - TO ASSIST IN DECRYPTING THE INFORMATION INTERCEPTED BY GOVT AGENCY ,2012,0,0,0,0,0,0,COMPUTER
WEST BENGAL,FAILURE - TO ASSIST IN DECRYPTING THE INFORMATION INTERCEPTED BY GOVT AGENCY ,2012,0,0,0,0,0,0,COMPUTER
TOTAL-STATES,FAILURE - TO ASSIST IN DECRYPTING THE INFORMATION INTERCEPTED BY GOVT AGENCY ,2012,0,2,0,0,0,2,COMPUTER
A & N ISLANDS,FAILURE - TO ASSIST IN DECRYPTING THE INFORMATION INTERCEPTED BY GOVT AGENCY ,2012,0,0,0,0,0,0,COMPUTER
CHANDIGARH,FAILURE - TO ASSIST IN DECRYPTING THE INFORMATION INTERCEPTED BY GOVT AGENCY ,2012,0,0,0,0,0,0,COMPUTER
D & N HAVELI,FAILURE - TO ASSIST IN DECRYPTING THE INFORMATION INTERCEPTED BY GOVT AGENCY ,2012,0,0,0,0,0,0,COMPUTER
DAMAN & DIU,FAILURE - TO ASSIST IN DECRYPTING THE INFORMATION INTERCEPTED BY GOVT AGENCY ,2012,0,0,0,0,0,0,COMPUTER
DELHI,FAILURE - TO ASSIST IN DECRYPTING THE INFORMATION INTERCEPTED BY GOVT AGENCY ,2012,0,1,0,0,0,1,COMPUTER
LAKSHADWEEP,FAILURE - TO ASSIST IN DECRYPTING THE INFORMATION INTERCEPTED BY GOVT AGENCY ,2012,0,0,0,0,0,0,COMPUTER
PUDUCHERRY,FAILURE - TO ASSIST IN DECRYPTING THE INFORMATION INTERCEPTED BY GOVT AGENCY ,2012,0,0,0,0,0,0,COMPUTER
TOTAL-UTs,FAILURE - TO ASSIST IN DECRYPTING THE INFORMATION INTERCEPTED BY GOVT AGENCY ,2012,0,1,0,0,0,1,COMPUTER
TOTAL-INDIA,FAILURE - TO ASSIST IN DECRYPTING THE INFORMATION INTERCEPTED BY GOVT AGENCY ,2012,0,3,0,0,0,3,COMPUTER
ANDHRA PRADESH,UN-AUTHORISED ACCESS ,2012,0,0,0,0,0,0,COMPUTER
ARUNACHAL PRADESH,UN-AUTHORISED ACCESS ,2012,0,0,0,0,0,0,COMPUTER
ASSAM,UN-AUTHORISED ACCESS ,2012,0,0,0,0,0,0,COMPUTER
BIHAR,UN-AUTHORISED ACCESS ,2012,0,0,0,0,0,0,COMPUTER
CHHATTISGARH,UN-AUTHORISED ACCESS ,2012,0,0,0,0,0,0,COMPUTER
GOA,UN-AUTHORISED ACCESS ,2012,0,0,0,0,0,0,COMPUTER
GUJARAT,UN-AUTHORISED ACCESS ,2012,0,0,0,0,0,0,COMPUTER
HARYANA,UN-AUTHORISED ACCESS ,2012,0,0,0,0,0,0,COMPUTER
HIMACHAL PRADESH,UN-AUTHORISED ACCESS ,2012,0,0,0,0,0,0,COMPUTER
JAMMU & KASHMIR,UN-AUTHORISED ACCESS ,2012,0,0,0,0,0,0,COMPUTER
JHARKHAND,UN-AUTHORISED ACCESS ,2012,0,0,0,0,0,0,COMPUTER
KARNATAKA,UN-AUTHORISED ACCESS ,2012,0,0,0,0,0,0,COMPUTER
KERALA,UN-AUTHORISED ACCESS ,2012,0,1,0,0,0,1,COMPUTER
MADHYA PRADESH,UN-AUTHORISED ACCESS ,2012,0,0,0,0,0,0,COMPUTER
MAHARASHTRA,UN-AUTHORISED ACCESS ,2012,0,0,0,0,0,0,COMPUTER
MANIPUR,UN-AUTHORISED ACCESS ,2012,0,0,0,0,0,0,COMPUTER
MEGHALAYA,UN-AUTHORISED ACCESS ,2012,0,0,0,0,0,0,COMPUTER
MIZORAM,UN-AUTHORISED ACCESS ,2012,0,0,0,0,0,0,COMPUTER
NAGALAND,UN-AUTHORISED ACCESS ,2012,0,0,0,0,0,0,COMPUTER
ORISSA,UN-AUTHORISED ACCESS ,2012,0,0,0,0,0,0,COMPUTER
PUNJAB,UN-AUTHORISED ACCESS ,2012,0,0,0,0,0,0,COMPUTER
RAJASTHAN,UN-AUTHORISED ACCESS ,2012,0,0,0,0,0,0,COMPUTER
SIKKIM,UN-AUTHORISED ACCESS ,2012,0,0,0,0,0,0,COMPUTER
TAMIL NADU,UN-AUTHORISED ACCESS ,2012,0,0,0,0,0,0,COMPUTER
TRIPURA,UN-AUTHORISED ACCESS ,2012,0,0,0,0,0,0,COMPUTER
UTTAR PRADESH,UN-AUTHORISED ACCESS ,2012,0,0,0,0,0,0,COMPUTER
UTTARAKHAND,UN-AUTHORISED ACCESS ,2012,0,0,0,0,0,0,COMPUTER
WEST BENGAL,UN-AUTHORISED ACCESS ,2012,0,0,0,0,0,0,COMPUTER
TOTAL-STATES,UN-AUTHORISED ACCESS ,2012,0,1,0,0,0,1,COMPUTER
A & N ISLANDS,UN-AUTHORISED ACCESS ,2012,0,0,0,0,0,0,COMPUTER
CHANDIGARH,UN-AUTHORISED ACCESS ,2012,0,0,0,0,0,0,COMPUTER
D & N HAVELI,UN-AUTHORISED ACCESS ,2012,0,0,0,0,0,0,COMPUTER
DAMAN & DIU,UN-AUTHORISED ACCESS ,2012,0,0,0,0,0,0,COMPUTER
DELHI,UN-AUTHORISED ACCESS ,2012,0,0,0,0,0,0,COMPUTER
LAKSHADWEEP,UN-AUTHORISED ACCESS ,2012,0,0,0,0,0,0,COMPUTER
PUDUCHERRY,UN-AUTHORISED ACCESS ,2012,0,0,0,0,0,0,COMPUTER
TOTAL-UTs,UN-AUTHORISED ACCESS ,2012,0,0,0,0,0,0,COMPUTER
TOTAL-INDIA,UN-AUTHORISED ACCESS ,2012,0,1,0,0,0,1,COMPUTER
ANDHRA PRADESH,OBTAINING LICENCE BY MISREPRESENTATION OF FACT ,2012,0,0,0,0,0,0,COMPUTER
ARUNACHAL PRADESH,OBTAINING LICENCE BY MISREPRESENTATION OF FACT ,2012,0,0,0,0,0,0,COMPUTER
ASSAM,OBTAINING LICENCE BY MISREPRESENTATION OF FACT ,2012,0,0,0,0,0,0,COMPUTER
BIHAR,OBTAINING LICENCE BY MISREPRESENTATION OF FACT ,2012,0,0,0,0,0,0,COMPUTER
CHHATTISGARH,OBTAINING LICENCE BY MISREPRESENTATION OF FACT ,2012,0,0,0,0,0,0,COMPUTER
GOA,OBTAINING LICENCE BY MISREPRESENTATION OF FACT ,2012,0,0,0,0,0,0,COMPUTER
GUJARAT,OBTAINING LICENCE BY MISREPRESENTATION OF FACT ,2012,0,0,0,0,0,0,COMPUTER
HARYANA,OBTAINING LICENCE BY MISREPRESENTATION OF FACT ,2012,0,0,0,0,0,0,COMPUTER
HIMACHAL PRADESH,OBTAINING LICENCE BY MISREPRESENTATION OF FACT ,2012,0,0,0,0,0,0,COMPUTER
JAMMU & KASHMIR,OBTAINING LICENCE BY MISREPRESENTATION OF FACT ,2012,0,0,0,0,0,0,COMPUTER
JHARKHAND,OBTAINING LICENCE BY MISREPRESENTATION OF FACT ,2012,0,0,0,0,0,0,COMPUTER
KARNATAKA,OBTAINING LICENCE BY MISREPRESENTATION OF FACT ,2012,0,0,0,0,0,0,COMPUTER
KERALA,OBTAINING LICENCE BY MISREPRESENTATION OF FACT ,2012,0,0,0,0,0,0,COMPUTER
MADHYA PRADESH,OBTAINING LICENCE BY MISREPRESENTATION OF FACT ,2012,0,4,0,0,0,4,COMPUTER
MAHARASHTRA,OBTAINING LICENCE BY MISREPRESENTATION OF FACT ,2012,0,0,0,0,0,0,COMPUTER
MANIPUR,OBTAINING LICENCE BY MISREPRESENTATION OF FACT ,2012,0,0,0,0,0,0,COMPUTER
MEGHALAYA,OBTAINING LICENCE BY MISREPRESENTATION OF FACT ,2012,0,0,0,0,0,0,COMPUTER
MIZORAM,OBTAINING LICENCE BY MISREPRESENTATION OF FACT ,2012,0,0,0,0,0,0,COMPUTER
NAGALAND,OBTAINING LICENCE BY MISREPRESENTATION OF FACT ,2012,0,0,0,0,0,0,COMPUTER
ORISSA,OBTAINING LICENCE BY MISREPRESENTATION OF FACT ,2012,0,0,0,0,0,0,COMPUTER
PUNJAB,OBTAINING LICENCE BY MISREPRESENTATION OF FACT ,2012,0,0,0,0,0,0,COMPUTER
RAJASTHAN,OBTAINING LICENCE BY MISREPRESENTATION OF FACT ,2012,0,0,0,0,0,0,COMPUTER
SIKKIM,OBTAINING LICENCE BY MISREPRESENTATION OF FACT ,2012,0,0,0,0,0,0,COMPUTER
TAMIL NADU,OBTAINING LICENCE BY MISREPRESENTATION OF FACT ,2012,0,0,0,0,0,0,COMPUTER
TRIPURA,OBTAINING LICENCE BY MISREPRESENTATION OF FACT ,2012,0,0,0,0,0,0,COMPUTER
UTTAR PRADESH,OBTAINING LICENCE BY MISREPRESENTATION OF FACT ,2012,0,0,0,1,0,1,COMPUTER
UTTARAKHAND,OBTAINING LICENCE BY MISREPRESENTATION OF FACT ,2012,0,0,0,0,0,0,COMPUTER
WEST BENGAL,OBTAINING LICENCE BY MISREPRESENTATION OF FACT ,2012,0,0,0,0,0,0,COMPUTER
TOTAL-STATES,OBTAINING LICENCE BY MISREPRESENTATION OF FACT ,2012,0,4,0,1,0,5,COMPUTER
A & N ISLANDS,OBTAINING LICENCE BY MISREPRESENTATION OF FACT ,2012,0,0,0,0,0,0,COMPUTER
CHANDIGARH,OBTAINING LICENCE BY MISREPRESENTATION OF FACT ,2012,0,0,0,0,0,0,COMPUTER
D & N HAVELI,OBTAINING LICENCE BY MISREPRESENTATION OF FACT ,2012,0,0,0,0,0,0,COMPUTER
DAMAN & DIU,OBTAINING LICENCE BY MISREPRESENTATION OF FACT ,2012,0,0,0,0,0,0,COMPUTER
DELHI,OBTAINING LICENCE BY MISREPRESENTATION OF FACT ,2012,0,0,0,0,0,0,COMPUTER
LAKSHADWEEP,OBTAINING LICENCE BY MISREPRESENTATION OF FACT ,2012,0,0,0,0,0,0,COMPUTER
PUDUCHERRY,OBTAINING LICENCE BY MISREPRESENTATION OF FACT ,2012,0,0,0,0,0,0,COMPUTER
TOTAL-UTs,OBTAINING LICENCE BY MISREPRESENTATION OF FACT ,2012,0,0,0,0,0,0,COMPUTER
TOTAL-INDIA,OBTAINING LICENCE BY MISREPRESENTATION OF FACT ,2012,0,4,0,1,0,5,COMPUTER
ANDHRA PRADESH,PUBLISHING FALSE DIGITAL SIGNATURE CERTIFICATE ,2012,0,0,0,0,0,0,COMPUTER
ARUNACHAL PRADESH,PUBLISHING FALSE DIGITAL SIGNATURE CERTIFICATE ,2012,0,0,0,0,0,0,COMPUTER
ASSAM,PUBLISHING FALSE DIGITAL SIGNATURE CERTIFICATE ,2012,0,0,0,0,0,0,COMPUTER
BIHAR,PUBLISHING FALSE DIGITAL SIGNATURE CERTIFICATE ,2012,0,0,0,0,0,0,COMPUTER
CHHATTISGARH,PUBLISHING FALSE DIGITAL SIGNATURE CERTIFICATE ,2012,0,0,0,0,0,0,COMPUTER
GOA,PUBLISHING FALSE DIGITAL SIGNATURE CERTIFICATE ,2012,0,0,0,0,0,0,COMPUTER
GUJARAT,PUBLISHING FALSE DIGITAL SIGNATURE CERTIFICATE ,2012,0,0,0,0,0,0,COMPUTER
HARYANA,PUBLISHING FALSE DIGITAL SIGNATURE CERTIFICATE ,2012,0,0,0,0,0,0,COMPUTER
HIMACHAL PRADESH,PUBLISHING FALSE DIGITAL SIGNATURE CERTIFICATE ,2012,0,0,0,0,0,0,COMPUTER
JAMMU & KASHMIR,PUBLISHING FALSE DIGITAL SIGNATURE CERTIFICATE ,2012,0,0,0,0,0,0,COMPUTER
JHARKHAND,PUBLISHING FALSE DIGITAL SIGNATURE CERTIFICATE ,2012,0,0,0,0,0,0,COMPUTER
KARNATAKA,PUBLISHING FALSE DIGITAL SIGNATURE CERTIFICATE ,2012,0,0,0,0,0,0,COMPUTER
KERALA,PUBLISHING FALSE DIGITAL SIGNATURE CERTIFICATE ,2012,0,0,0,0,0,0,COMPUTER
MADHYA PRADESH,PUBLISHING FALSE DIGITAL SIGNATURE CERTIFICATE ,2012,0,0,0,0,0,0,COMPUTER
MAHARASHTRA,PUBLISHING FALSE DIGITAL SIGNATURE CERTIFICATE ,2012,0,0,0,0,0,0,COMPUTER
MANIPUR,PUBLISHING FALSE DIGITAL SIGNATURE CERTIFICATE ,2012,0,0,0,0,0,0,COMPUTER
MEGHALAYA,PUBLISHING FALSE DIGITAL SIGNATURE CERTIFICATE ,2012,0,0,0,0,0,0,COMPUTER
MIZORAM,PUBLISHING FALSE DIGITAL SIGNATURE CERTIFICATE ,2012,0,0,0,0,0,0,COMPUTER
NAGALAND,PUBLISHING FALSE DIGITAL SIGNATURE CERTIFICATE ,2012,0,0,0,0,0,0,COMPUTER
ORISSA,PUBLISHING FALSE DIGITAL SIGNATURE CERTIFICATE ,2012,0,0,0,0,0,0,COMPUTER
PUNJAB,PUBLISHING FALSE DIGITAL SIGNATURE CERTIFICATE ,2012,0,0,0,0,0,0,COMPUTER
RAJASTHAN,PUBLISHING FALSE DIGITAL SIGNATURE CERTIFICATE ,2012,0,0,0,0,0,0,COMPUTER
SIKKIM,PUBLISHING FALSE DIGITAL SIGNATURE CERTIFICATE ,2012,0,0,0,0,0,0,COMPUTER
TAMIL NADU,PUBLISHING FALSE DIGITAL SIGNATURE CERTIFICATE ,2012,0,0,0,0,0,0,COMPUTER
TRIPURA,PUBLISHING FALSE DIGITAL SIGNATURE CERTIFICATE ,2012,0,0,0,0,0,0,COMPUTER
UTTAR PRADESH,PUBLISHING FALSE DIGITAL SIGNATURE CERTIFICATE ,2012,0,0,0,0,0,0,COMPUTER
UTTARAKHAND,PUBLISHING FALSE DIGITAL SIGNATURE CERTIFICATE ,2012,0,0,0,0,0,0,COMPUTER
WEST BENGAL,PUBLISHING FALSE DIGITAL SIGNATURE CERTIFICATE ,2012,0,0,0,0,0,0,COMPUTER
TOTAL-STATES,PUBLISHING FALSE DIGITAL SIGNATURE CERTIFICATE ,2012,0,0,0,0,0,0,COMPUTER
A & N ISLANDS,PUBLISHING FALSE DIGITAL SIGNATURE CERTIFICATE ,2012,0,0,0,0,0,0,COMPUTER
CHANDIGARH,PUBLISHING FALSE DIGITAL SIGNATURE CERTIFICATE ,2012,0,0,0,0,0,0,COMPUTER
D & N HAVELI,PUBLISHING FALSE DIGITAL SIGNATURE CERTIFICATE ,2012,0,0,0,0,0,0,COMPUTER
DAMAN & DIU,PUBLISHING FALSE DIGITAL SIGNATURE CERTIFICATE ,2012,0,0,0,0,0,0,COMPUTER
DELHI,PUBLISHING FALSE DIGITAL SIGNATURE CERTIFICATE ,2012,0,0,0,0,0,0,COMPUTER
LAKSHADWEEP,PUBLISHING FALSE DIGITAL SIGNATURE CERTIFICATE ,2012,0,0,0,0,0,0,COMPUTER
PUDUCHERRY,PUBLISHING FALSE DIGITAL SIGNATURE CERTIFICATE ,2012,0,0,0,0,0,0,COMPUTER
TOTAL-UTs,PUBLISHING FALSE DIGITAL SIGNATURE CERTIFICATE ,2012,0,0,0,0,0,0,COMPUTER
TOTAL-INDIA,PUBLISHING FALSE DIGITAL SIGNATURE CERTIFICATE ,2012,0,0,0,0,0,0,COMPUTER
ANDHRA PRADESH,FRAUD DIGITAL SIGNATURE CERTIFICATE ,2012,0,0,0,0,0,0,COMPUTER
ARUNACHAL PRADESH,FRAUD DIGITAL SIGNATURE CERTIFICATE ,2012,0,0,0,0,0,0,COMPUTER
ASSAM,FRAUD DIGITAL SIGNATURE CERTIFICATE ,2012,0,0,0,0,0,0,COMPUTER
BIHAR,FRAUD DIGITAL SIGNATURE CERTIFICATE ,2012,0,0,0,0,0,0,COMPUTER
CHHATTISGARH,FRAUD DIGITAL SIGNATURE CERTIFICATE ,2012,0,0,0,0,0,0,COMPUTER
GOA,FRAUD DIGITAL SIGNATURE CERTIFICATE ,2012,0,0,0,0,0,0,COMPUTER
GUJARAT,FRAUD DIGITAL SIGNATURE CERTIFICATE ,2012,0,0,0,0,0,0,COMPUTER
HARYANA,FRAUD DIGITAL SIGNATURE CERTIFICATE ,2012,0,0,0,0,0,0,COMPUTER
HIMACHAL PRADESH,FRAUD DIGITAL SIGNATURE CERTIFICATE ,2012,0,0,0,0,0,0,COMPUTER
JAMMU & KASHMIR,FRAUD DIGITAL SIGNATURE CERTIFICATE ,2012,0,0,0,0,0,0,COMPUTER
JHARKHAND,FRAUD DIGITAL SIGNATURE CERTIFICATE ,2012,0,0,0,0,0,0,COMPUTER
KARNATAKA,FRAUD DIGITAL SIGNATURE CERTIFICATE ,2012,0,0,3,0,0,3,COMPUTER
KERALA,FRAUD DIGITAL SIGNATURE CERTIFICATE ,2012,0,0,0,0,0,0,COMPUTER
MADHYA PRADESH,FRAUD DIGITAL SIGNATURE CERTIFICATE ,2012,0,0,0,0,0,0,COMPUTER
MAHARASHTRA,FRAUD DIGITAL SIGNATURE CERTIFICATE ,2012,0,0,0,0,0,0,COMPUTER
MANIPUR,FRAUD DIGITAL SIGNATURE CERTIFICATE ,2012,0,0,0,0,0,0,COMPUTER
MEGHALAYA,FRAUD DIGITAL SIGNATURE CERTIFICATE ,2012,0,0,0,0,0,0,COMPUTER
MIZORAM,FRAUD DIGITAL SIGNATURE CERTIFICATE ,2012,0,0,0,0,0,0,COMPUTER
NAGALAND,FRAUD DIGITAL SIGNATURE CERTIFICATE ,2012,0,0,0,0,0,0,COMPUTER
ORISSA,FRAUD DIGITAL SIGNATURE CERTIFICATE ,2012,0,0,0,0,0,0,COMPUTER
PUNJAB,FRAUD DIGITAL SIGNATURE CERTIFICATE ,2012,0,0,0,0,0,0,COMPUTER
RAJASTHAN,FRAUD DIGITAL SIGNATURE CERTIFICATE ,2012,0,0,0,0,0,0,COMPUTER
SIKKIM,FRAUD DIGITAL SIGNATURE CERTIFICATE ,2012,0,0,0,0,0,0,COMPUTER
TAMIL NADU,FRAUD DIGITAL SIGNATURE CERTIFICATE ,2012,0,0,0,0,0,0,COMPUTER
TRIPURA,FRAUD DIGITAL SIGNATURE CERTIFICATE ,2012,0,0,0,0,0,0,COMPUTER
UTTAR PRADESH,FRAUD DIGITAL SIGNATURE CERTIFICATE ,2012,0,0,0,0,0,0,COMPUTER
UTTARAKHAND,FRAUD DIGITAL SIGNATURE CERTIFICATE ,2012,0,0,0,0,0,0,COMPUTER
WEST BENGAL,FRAUD DIGITAL SIGNATURE CERTIFICATE ,2012,0,0,0,0,0,0,COMPUTER
TOTAL-STATES,FRAUD DIGITAL SIGNATURE CERTIFICATE ,2012,0,0,3,0,0,3,COMPUTER
A & N ISLANDS,FRAUD DIGITAL SIGNATURE CERTIFICATE ,2012,0,0,0,0,0,0,COMPUTER
CHANDIGARH,FRAUD DIGITAL SIGNATURE CERTIFICATE ,2012,0,0,0,0,0,0,COMPUTER
D & N HAVELI,FRAUD DIGITAL SIGNATURE CERTIFICATE ,2012,0,0,0,0,0,0,COMPUTER
DAMAN & DIU,FRAUD DIGITAL SIGNATURE CERTIFICATE ,2012,0,0,0,0,0,0,COMPUTER
DELHI,FRAUD DIGITAL SIGNATURE CERTIFICATE ,2012,0,0,0,0,0,0,COMPUTER
LAKSHADWEEP,FRAUD DIGITAL SIGNATURE CERTIFICATE ,2012,0,0,0,0,0,0,COMPUTER
PUDUCHERRY,FRAUD DIGITAL SIGNATURE CERTIFICATE ,2012,0,0,0,0,0,0,COMPUTER
TOTAL-UTs,FRAUD DIGITAL SIGNATURE CERTIFICATE ,2012,0,0,0,0,0,0,COMPUTER
TOTAL-INDIA,FRAUD DIGITAL SIGNATURE CERTIFICATE ,2012,0,0,3,0,0,3,COMPUTER
ANDHRA PRADESH,BREACH OF CONFIDENTIALITY ,2012,0,4,0,0,0,4,COMPUTER
ARUNACHAL PRADESH,BREACH OF CONFIDENTIALITY ,2012,0,0,0,0,0,0,COMPUTER
ASSAM,BREACH OF CONFIDENTIALITY ,2012,0,0,0,0,0,0,COMPUTER
BIHAR,BREACH OF CONFIDENTIALITY ,2012,0,0,0,0,0,0,COMPUTER
CHHATTISGARH,BREACH OF CONFIDENTIALITY ,2012,0,0,0,0,0,0,COMPUTER
GOA,BREACH OF CONFIDENTIALITY ,2012,0,0,0,0,0,0,COMPUTER
GUJARAT,BREACH OF CONFIDENTIALITY ,2012,0,0,0,0,0,0,COMPUTER
HARYANA,BREACH OF CONFIDENTIALITY ,2012,0,0,0,0,0,0,COMPUTER
HIMACHAL PRADESH,BREACH OF CONFIDENTIALITY ,2012,0,0,0,0,0,0,COMPUTER
JAMMU & KASHMIR,BREACH OF CONFIDENTIALITY ,2012,0,0,0,0,0,0,COMPUTER
JHARKHAND,BREACH OF CONFIDENTIALITY ,2012,0,1,0,0,0,1,COMPUTER
KARNATAKA,BREACH OF CONFIDENTIALITY ,2012,1,3,0,0,0,4,COMPUTER
KERALA,BREACH OF CONFIDENTIALITY ,2012,0,4,2,1,0,7,COMPUTER
MADHYA PRADESH,BREACH OF CONFIDENTIALITY ,2012,0,0,0,0,0,0,COMPUTER
MAHARASHTRA,BREACH OF CONFIDENTIALITY ,2012,0,2,0,0,0,2,COMPUTER
MANIPUR,BREACH OF CONFIDENTIALITY ,2012,0,0,0,0,0,0,COMPUTER
MEGHALAYA,BREACH OF CONFIDENTIALITY ,2012,0,0,0,0,0,0,COMPUTER
MIZORAM,BREACH OF CONFIDENTIALITY ,2012,0,0,0,0,0,0,COMPUTER
NAGALAND,BREACH OF CONFIDENTIALITY ,2012,0,0,0,0,0,0,COMPUTER
ORISSA,BREACH OF CONFIDENTIALITY ,2012,0,0,0,0,0,0,COMPUTER
PUNJAB,BREACH OF CONFIDENTIALITY ,2012,0,0,1,0,0,1,COMPUTER
RAJASTHAN,BREACH OF CONFIDENTIALITY ,2012,0,0,0,0,0,0,COMPUTER
SIKKIM,BREACH OF CONFIDENTIALITY ,2012,0,0,0,0,0,0,COMPUTER
TAMIL NADU,BREACH OF CONFIDENTIALITY ,2012,0,0,0,0,0,0,COMPUTER
TRIPURA,BREACH OF CONFIDENTIALITY ,2012,0,0,0,0,0,0,COMPUTER
UTTAR PRADESH,BREACH OF CONFIDENTIALITY ,2012,0,1,0,0,0,1,COMPUTER
UTTARAKHAND,BREACH OF CONFIDENTIALITY ,2012,0,0,0,0,0,0,COMPUTER
WEST BENGAL,BREACH OF CONFIDENTIALITY ,2012,0,2,0,0,0,2,COMPUTER
TOTAL-STATES,BREACH OF CONFIDENTIALITY ,2012,1,17,3,1,0,22,COMPUTER
A & N ISLANDS,BREACH OF CONFIDENTIALITY ,2012,0,0,0,0,0,0,COMPUTER
CHANDIGARH,BREACH OF CONFIDENTIALITY ,2012,0,0,0,0,0,0,COMPUTER
D & N HAVELI,BREACH OF CONFIDENTIALITY ,2012,0,0,0,0,0,0,COMPUTER
DAMAN & DIU,BREACH OF CONFIDENTIALITY ,2012,0,0,0,0,0,0,COMPUTER
DELHI,BREACH OF CONFIDENTIALITY ,2012,0,0,0,0,0,0,COMPUTER
LAKSHADWEEP,BREACH OF CONFIDENTIALITY ,2012,0,0,0,0,0,0,COMPUTER
PUDUCHERRY,BREACH OF CONFIDENTIALITY ,2012,0,0,0,0,0,0,COMPUTER
TOTAL-UTs,BREACH OF CONFIDENTIALITY ,2012,0,0,0,0,0,0,COMPUTER
TOTAL-INDIA,BREACH OF CONFIDENTIALITY ,2012,1,17,3,1,0,22,COMPUTER
ANDHRA PRADESH,OTHER ,2012,0,0,0,0,0,0,COMPUTER
ARUNACHAL PRADESH,OTHER ,2012,0,0,0,0,0,0,COMPUTER
ASSAM,OTHER ,2012,0,0,0,0,0,0,COMPUTER
BIHAR,OTHER ,2012,0,0,0,0,0,0,COMPUTER
CHHATTISGARH,OTHER ,2012,0,0,0,0,0,0,COMPUTER
GOA,OTHER ,2012,0,0,0,0,0,0,COMPUTER
GUJARAT,OTHER ,2012,0,0,0,0,0,0,COMPUTER
HARYANA,OTHER ,2012,0,0,0,0,0,0,COMPUTER
HIMACHAL PRADESH,OTHER ,2012,0,0,0,0,0,0,COMPUTER
JAMMU & KASHMIR,OTHER ,2012,0,2,0,0,0,2,COMPUTER
JHARKHAND,OTHER ,2012,0,0,0,0,0,0,COMPUTER
KARNATAKA,OTHER ,2012,0,0,0,0,0,0,COMPUTER
KERALA,OTHER ,2012,0,0,0,0,0,0,COMPUTER
MADHYA PRADESH,OTHER ,2012,0,0,0,0,0,0,COMPUTER
MAHARASHTRA,OTHER ,2012,4,79,36,13,0,132,COMPUTER
MANIPUR,OTHER ,2012,0,0,0,0,0,0,COMPUTER
MEGHALAYA,OTHER ,2012,0,0,0,0,0,0,COMPUTER
MIZORAM,OTHER ,2012,0,0,0,0,0,0,COMPUTER
NAGALAND,OTHER ,2012,0,0,0,0,0,0,COMPUTER
ORISSA,OTHER ,2012,0,0,0,0,0,0,COMPUTER
PUNJAB,OTHER ,2012,0,0,0,0,0,0,COMPUTER
RAJASTHAN,OTHER ,2012,0,0,0,0,0,0,COMPUTER
SIKKIM,OTHER ,2012,0,0,0,0,0,0,COMPUTER
TAMIL NADU,OTHER ,2012,0,0,0,0,0,0,COMPUTER
TRIPURA,OTHER ,2012,0,0,0,0,0,0,COMPUTER
UTTAR PRADESH,OTHER ,2012,0,0,0,0,0,0,COMPUTER
UTTARAKHAND,OTHER ,2012,0,0,0,0,0,0,COMPUTER
WEST BENGAL,OTHER ,2012,0,0,0,0,0,0,COMPUTER
TOTAL-STATES,OTHER ,2012,4,81,36,13,0,134,COMPUTER
A & N ISLANDS,OTHER ,2012,0,0,0,0,0,0,COMPUTER
CHANDIGARH,OTHER ,2012,0,0,0,0,0,0,COMPUTER
D & N HAVELI,OTHER ,2012,0,0,0,0,0,0,COMPUTER
DAMAN & DIU,OTHER ,2012,0,0,0,0,0,0,COMPUTER
DELHI,OTHER ,2012,0,0,0,0,0,0,COMPUTER
LAKSHADWEEP,OTHER ,2012,0,0,0,0,0,0,COMPUTER
PUDUCHERRY,OTHER ,2012,0,0,0,0,0,0,COMPUTER
TOTAL-UTs,OTHER ,2012,0,0,0,0,0,0,COMPUTER
TOTAL-INDIA,OTHER ,2012,4,81,36,13,0,134,COMPUTER
ANDHRA PRADESH,TOTAL ,2012,0,125,35,10,0,170,COMPUTER
ARUNACHAL PRADESH,TOTAL ,2012,0,0,3,3,0,6,COMPUTER
ASSAM,TOTAL ,2012,0,5,0,0,0,5,COMPUTER
BIHAR,TOTAL ,2012,0,14,3,0,0,17,COMPUTER
CHHATTISGARH,TOTAL ,2012,4,25,2,0,0,31,COMPUTER
GOA,TOTAL ,2012,1,3,5,1,0,10,COMPUTER
GUJARAT,TOTAL ,2012,1,41,23,7,0,72,COMPUTER
HARYANA,TOTAL ,2012,0,12,12,1,0,25,COMPUTER
HIMACHAL PRADESH,TOTAL ,2012,3,19,1,2,0,25,COMPUTER
JAMMU & KASHMIR,TOTAL ,2012,0,11,6,0,0,17,COMPUTER
JHARKHAND,TOTAL ,2012,0,8,0,0,0,8,COMPUTER
KARNATAKA,TOTAL ,2012,3,35,24,4,0,66,COMPUTER
KERALA,TOTAL ,2012,15,81,44,11,0,151,COMPUTER
MADHYA PRADESH,TOTAL ,2012,13,105,32,2,0,152,COMPUTER
MAHARASHTRA,TOTAL ,2012,9,215,75,24,1,324,COMPUTER
MANIPUR,TOTAL ,2012,0,0,0,0,0,0,COMPUTER
MEGHALAYA,TOTAL ,2012,0,0,0,0,0,0,COMPUTER
MIZORAM,TOTAL ,2012,0,0,0,0,0,0,COMPUTER
NAGALAND,TOTAL ,2012,0,0,0,0,0,0,COMPUTER
ORISSA,TOTAL ,2012,0,0,1,0,0,1,COMPUTER
PUNJAB,TOTAL ,2012,0,22,56,8,0,86,COMPUTER
RAJASTHAN,TOTAL ,2012,13,55,18,4,0,90,COMPUTER
SIKKIM,TOTAL ,2012,0,0,0,0,0,0,COMPUTER
TAMIL NADU,TOTAL ,2012,1,20,8,3,1,33,COMPUTER
TRIPURA,TOTAL ,2012,0,7,3,0,0,10,COMPUTER
UTTAR PRADESH,TOTAL ,2012,0,60,47,4,1,112,COMPUTER
UTTARAKHAND,TOTAL ,2012,0,2,0,0,0,2,COMPUTER
WEST BENGAL,TOTAL ,2012,2,43,22,6,0,73,COMPUTER
TOTAL-STATES,TOTAL ,2012,65,908,420,90,3,1486,COMPUTER
A & N ISLANDS,TOTAL ,2012,0,0,0,0,0,0,COMPUTER
CHANDIGARH,TOTAL ,2012,0,3,2,0,0,5,COMPUTER
D & N HAVELI,TOTAL ,2012,0,0,0,0,0,0,COMPUTER
DAMAN & DIU,TOTAL ,2012,0,0,0,0,0,0,COMPUTER
DELHI,TOTAL ,2012,0,17,10,0,0,27,COMPUTER
LAKSHADWEEP,TOTAL ,2012,0,0,0,0,0,0,COMPUTER
PUDUCHERRY,TOTAL ,2012,0,0,4,0,0,4,COMPUTER
TOTAL-UTs,TOTAL ,2012,0,20,16,0,0,36,COMPUTER
TOTAL-INDIA,TOTAL ,2012,65,928,436,90,3,1522,COMPUTER
ANDHRA PRADESH,OFFENCES BY OR AGAINST PUBLIC SERVANT ,2012,0,0,0,0,0,0,COMPUTER
ARUNACHAL PRADESH,OFFENCES BY OR AGAINST PUBLIC SERVANT ,2012,0,0,0,0,0,0,COMPUTER
ASSAM,OFFENCES BY OR AGAINST PUBLIC SERVANT ,2012,0,0,0,0,0,0,COMPUTER
BIHAR,OFFENCES BY OR AGAINST PUBLIC SERVANT ,2012,0,0,0,0,0,0,COMPUTER
CHHATTISGARH,OFFENCES BY OR AGAINST PUBLIC SERVANT ,2012,0,0,0,0,0,0,COMPUTER
GOA,OFFENCES BY OR AGAINST PUBLIC SERVANT ,2012,0,0,0,0,0,0,COMPUTER
GUJARAT,OFFENCES BY OR AGAINST PUBLIC SERVANT ,2012,0,0,0,0,0,0,COMPUTER
HARYANA,OFFENCES BY OR AGAINST PUBLIC SERVANT ,2012,0,0,0,0,0,0,COMPUTER
HIMACHAL PRADESH,OFFENCES BY OR AGAINST PUBLIC SERVANT ,2012,0,0,0,0,0,0,COMPUTER
JAMMU & KASHMIR,OFFENCES BY OR AGAINST PUBLIC SERVANT ,2012,0,0,0,0,0,0,COMPUTER
JHARKHAND,OFFENCES BY OR AGAINST PUBLIC SERVANT ,2012,0,0,0,0,0,0,COMPUTER
KARNATAKA,OFFENCES BY OR AGAINST PUBLIC SERVANT ,2012,0,0,0,0,0,0,COMPUTER
KERALA,OFFENCES BY OR AGAINST PUBLIC SERVANT ,2012,0,0,0,0,0,0,COMPUTER
MADHYA PRADESH,OFFENCES BY OR AGAINST PUBLIC SERVANT ,2012,0,0,0,0,0,0,COMPUTER
MAHARASHTRA,OFFENCES BY OR AGAINST PUBLIC SERVANT ,2012,0,1,2,1,0,4,COMPUTER
MANIPUR,OFFENCES BY OR AGAINST PUBLIC SERVANT ,2012,0,0,0,0,0,0,COMPUTER
MEGHALAYA,OFFENCES BY OR AGAINST PUBLIC SERVANT ,2012,0,0,0,0,0,0,COMPUTER
MIZORAM,OFFENCES BY OR AGAINST PUBLIC SERVANT ,2012,0,0,0,0,0,0,COMPUTER
NAGALAND,OFFENCES BY OR AGAINST PUBLIC SERVANT ,2012,0,0,0,0,0,0,COMPUTER
ORISSA,OFFENCES BY OR AGAINST PUBLIC SERVANT ,2012,0,0,0,0,0,0,COMPUTER
PUNJAB,OFFENCES BY OR AGAINST PUBLIC SERVANT ,2012,0,0,0,0,0,0,COMPUTER
RAJASTHAN,OFFENCES BY OR AGAINST PUBLIC SERVANT ,2012,0,0,0,0,0,0,COMPUTER
SIKKIM,OFFENCES BY OR AGAINST PUBLIC SERVANT ,2012,0,0,0,0,0,0,COMPUTER
TAMIL NADU,OFFENCES BY OR AGAINST PUBLIC SERVANT ,2012,0,0,0,0,0,0,COMPUTER
TRIPURA,OFFENCES BY OR AGAINST PUBLIC SERVANT ,2012,0,0,0,0,0,0,COMPUTER
UTTAR PRADESH,OFFENCES BY OR AGAINST PUBLIC SERVANT ,2012,0,0,0,0,0,0,COMPUTER
UTTARAKHAND,OFFENCES BY OR AGAINST PUBLIC SERVANT ,2012,0,0,0,0,0,0,COMPUTER
WEST BENGAL,OFFENCES BY OR AGAINST PUBLIC SERVANT ,2012,0,0,0,0,0,0,COMPUTER
TOTAL-STATES,OFFENCES BY OR AGAINST PUBLIC SERVANT ,2012,0,1,2,1,0,4,COMPUTER
A & N ISLANDS,OFFENCES BY OR AGAINST PUBLIC SERVANT ,2012,0,0,0,0,0,0,COMPUTER
CHANDIGARH,OFFENCES BY OR AGAINST PUBLIC SERVANT ,2012,0,0,0,0,0,0,COMPUTER
D & N HAVELI,OFFENCES BY OR AGAINST PUBLIC SERVANT ,2012,0,0,0,0,0,0,COMPUTER
DAMAN & DIU,OFFENCES BY OR AGAINST PUBLIC SERVANT ,2012,0,0,0,0,0,0,COMPUTER
DELHI,OFFENCES BY OR AGAINST PUBLIC SERVANT ,2012,0,0,0,0,0,0,COMPUTER
LAKSHADWEEP,OFFENCES BY OR AGAINST PUBLIC SERVANT ,2012,0,0,0,0,0,0,COMPUTER
PUDUCHERRY,OFFENCES BY OR AGAINST PUBLIC SERVANT ,2012,0,0,0,0,0,0,COMPUTER
TOTAL-UTs,OFFENCES BY OR AGAINST PUBLIC SERVANT ,2012,0,0,0,0,0,0,COMPUTER
TOTAL-INDIA,OFFENCES BY OR AGAINST PUBLIC SERVANT ,2012,0,1,2,1,0,4,COMPUTER
ANDHRA PRADESH,FALSE ELECTRONIC EVIDENCE ,2012,0,0,0,0,0,0,COMPUTER
ARUNACHAL PRADESH,FALSE ELECTRONIC EVIDENCE ,2012,0,0,0,0,0,0,COMPUTER
ASSAM,FALSE ELECTRONIC EVIDENCE ,2012,0,0,0,0,0,0,COMPUTER
BIHAR,FALSE ELECTRONIC EVIDENCE ,2012,0,0,0,0,0,0,COMPUTER
CHHATTISGARH,FALSE ELECTRONIC EVIDENCE ,2012,0,0,0,0,0,0,COMPUTER
GOA,FALSE ELECTRONIC EVIDENCE ,2012,0,0,0,0,0,0,COMPUTER
GUJARAT,FALSE ELECTRONIC EVIDENCE ,2012,0,0,0,0,0,0,COMPUTER
HARYANA,FALSE ELECTRONIC EVIDENCE ,2012,0,0,0,0,0,0,COMPUTER
HIMACHAL PRADESH,FALSE ELECTRONIC EVIDENCE ,2012,0,0,0,0,0,0,COMPUTER
JAMMU & KASHMIR,FALSE ELECTRONIC EVIDENCE ,2012,0,0,0,0,0,0,COMPUTER
JHARKHAND,FALSE ELECTRONIC EVIDENCE ,2012,0,0,0,0,0,0,COMPUTER
KARNATAKA,FALSE ELECTRONIC EVIDENCE ,2012,0,0,0,0,0,0,COMPUTER
KERALA,FALSE ELECTRONIC EVIDENCE ,2012,0,1,1,0,0,2,COMPUTER
MADHYA PRADESH,FALSE ELECTRONIC EVIDENCE ,2012,0,0,0,0,0,0,COMPUTER
MAHARASHTRA,FALSE ELECTRONIC EVIDENCE ,2012,0,0,0,0,0,0,COMPUTER
MANIPUR,FALSE ELECTRONIC EVIDENCE ,2012,0,0,0,0,0,0,COMPUTER
MEGHALAYA,FALSE ELECTRONIC EVIDENCE ,2012,0,0,0,0,0,0,COMPUTER
MIZORAM,FALSE ELECTRONIC EVIDENCE ,2012,0,0,0,0,0,0,COMPUTER
NAGALAND,FALSE ELECTRONIC EVIDENCE ,2012,0,0,0,0,0,0,COMPUTER
ORISSA,FALSE ELECTRONIC EVIDENCE ,2012,0,0,0,0,0,0,COMPUTER
PUNJAB,FALSE ELECTRONIC EVIDENCE ,2012,0,0,0,0,0,0,COMPUTER
RAJASTHAN,FALSE ELECTRONIC EVIDENCE ,2012,0,0,0,0,0,0,COMPUTER
SIKKIM,FALSE ELECTRONIC EVIDENCE ,2012,0,0,0,0,0,0,COMPUTER
TAMIL NADU,FALSE ELECTRONIC EVIDENCE ,2012,0,0,0,0,0,0,COMPUTER
TRIPURA,FALSE ELECTRONIC EVIDENCE ,2012,0,0,0,0,0,0,COMPUTER
UTTAR PRADESH,FALSE ELECTRONIC EVIDENCE ,2012,0,0,0,0,0,0,COMPUTER
UTTARAKHAND,FALSE ELECTRONIC EVIDENCE ,2012,0,0,0,0,0,0,COMPUTER
WEST BENGAL,FALSE ELECTRONIC EVIDENCE ,2012,0,0,0,0,0,0,COMPUTER
TOTAL-STATES,FALSE ELECTRONIC EVIDENCE ,2012,0,1,1,0,0,2,COMPUTER
A & N ISLANDS,FALSE ELECTRONIC EVIDENCE ,2012,0,0,0,0,0,0,COMPUTER
CHANDIGARH,FALSE ELECTRONIC EVIDENCE ,2012,0,0,0,0,0,0,COMPUTER
D & N HAVELI,FALSE ELECTRONIC EVIDENCE ,2012,0,0,0,0,0,0,COMPUTER
DAMAN & DIU,FALSE ELECTRONIC EVIDENCE ,2012,0,0,0,0,0,0,COMPUTER
DELHI,FALSE ELECTRONIC EVIDENCE ,2012,0,0,0,0,0,0,COMPUTER
LAKSHADWEEP,FALSE ELECTRONIC EVIDENCE ,2012,0,0,0,0,0,0,COMPUTER
PUDUCHERRY,FALSE ELECTRONIC EVIDENCE ,2012,0,0,0,0,0,0,COMPUTER
TOTAL-UTs,FALSE ELECTRONIC EVIDENCE ,2012,0,0,0,0,0,0,COMPUTER
TOTAL-INDIA,FALSE ELECTRONIC EVIDENCE ,2012,0,1,1,0,0,2,COMPUTER
ANDHRA PRADESH,DESTRUCTION OF ELECTRONIC EVIDENCE ,2012,0,0,0,0,0,0,COMPUTER
ARUNACHAL PRADESH,DESTRUCTION OF ELECTRONIC EVIDENCE ,2012,0,0,0,0,0,0,COMPUTER
ASSAM,DESTRUCTION OF ELECTRONIC EVIDENCE ,2012,0,0,0,0,0,0,COMPUTER
BIHAR,DESTRUCTION OF ELECTRONIC EVIDENCE ,2012,0,0,0,0,0,0,COMPUTER
CHHATTISGARH,DESTRUCTION OF ELECTRONIC EVIDENCE ,2012,0,0,0,0,0,0,COMPUTER
GOA,DESTRUCTION OF ELECTRONIC EVIDENCE ,2012,0,0,0,0,0,0,COMPUTER
GUJARAT,DESTRUCTION OF ELECTRONIC EVIDENCE ,2012,0,0,0,0,0,0,COMPUTER
HARYANA,DESTRUCTION OF ELECTRONIC EVIDENCE ,2012,0,7,0,2,0,9,COMPUTER
HIMACHAL PRADESH,DESTRUCTION OF ELECTRONIC EVIDENCE ,2012,0,0,0,0,0,0,COMPUTER
JAMMU & KASHMIR,DESTRUCTION OF ELECTRONIC EVIDENCE ,2012,0,0,0,0,0,0,COMPUTER
JHARKHAND,DESTRUCTION OF ELECTRONIC EVIDENCE ,2012,0,0,0,0,0,0,COMPUTER
KARNATAKA,DESTRUCTION OF ELECTRONIC EVIDENCE ,2012,0,0,0,0,0,0,COMPUTER
KERALA,DESTRUCTION OF ELECTRONIC EVIDENCE ,2012,0,0,0,0,0,0,COMPUTER
MADHYA PRADESH,DESTRUCTION OF ELECTRONIC EVIDENCE ,2012,0,0,0,0,0,0,COMPUTER
MAHARASHTRA,DESTRUCTION OF ELECTRONIC EVIDENCE ,2012,0,0,0,0,0,0,COMPUTER
MANIPUR,DESTRUCTION OF ELECTRONIC EVIDENCE ,2012,0,0,0,0,0,0,COMPUTER
MEGHALAYA,DESTRUCTION OF ELECTRONIC EVIDENCE ,2012,0,0,0,0,0,0,COMPUTER
MIZORAM,DESTRUCTION OF ELECTRONIC EVIDENCE ,2012,0,0,0,0,0,0,COMPUTER
NAGALAND,DESTRUCTION OF ELECTRONIC EVIDENCE ,2012,0,0,0,0,0,0,COMPUTER
ORISSA,DESTRUCTION OF ELECTRONIC EVIDENCE ,2012,0,0,0,0,0,0,COMPUTER
PUNJAB,DESTRUCTION OF ELECTRONIC EVIDENCE ,2012,0,0,0,0,0,0,COMPUTER
RAJASTHAN,DESTRUCTION OF ELECTRONIC EVIDENCE ,2012,0,0,0,0,0,0,COMPUTER
SIKKIM,DESTRUCTION OF ELECTRONIC EVIDENCE ,2012,0,0,0,0,0,0,COMPUTER
TAMIL NADU,DESTRUCTION OF ELECTRONIC EVIDENCE ,2012,0,0,0,0,0,0,COMPUTER
TRIPURA,DESTRUCTION OF ELECTRONIC EVIDENCE ,2012,0,0,0,0,0,0,COMPUTER
UTTAR PRADESH,DESTRUCTION OF ELECTRONIC EVIDENCE ,2012,0,3,3,0,0,6,COMPUTER
UTTARAKHAND,DESTRUCTION OF ELECTRONIC EVIDENCE ,2012,0,0,0,0,0,0,COMPUTER
WEST BENGAL,DESTRUCTION OF ELECTRONIC EVIDENCE ,2012,0,1,0,0,0,1,COMPUTER
TOTAL-STATES,DESTRUCTION OF ELECTRONIC EVIDENCE ,2012,0,11,3,2,0,16,COMPUTER
A & N ISLANDS,DESTRUCTION OF ELECTRONIC EVIDENCE ,2012,0,0,0,0,0,0,COMPUTER
CHANDIGARH,DESTRUCTION OF ELECTRONIC EVIDENCE ,2012,0,0,0,0,0,0,COMPUTER
D & N HAVELI,DESTRUCTION OF ELECTRONIC EVIDENCE ,2012,0,0,0,0,0,0,COMPUTER
DAMAN & DIU,DESTRUCTION OF ELECTRONIC EVIDENCE ,2012,0,0,0,0,0,0,COMPUTER
DELHI,DESTRUCTION OF ELECTRONIC EVIDENCE ,2012,0,0,0,0,0,0,COMPUTER
LAKSHADWEEP,DESTRUCTION OF ELECTRONIC EVIDENCE ,2012,0,0,0,0,0,0,COMPUTER
PUDUCHERRY,DESTRUCTION OF ELECTRONIC EVIDENCE ,2012,0,0,0,0,0,0,COMPUTER
TOTAL-UTs,DESTRUCTION OF ELECTRONIC EVIDENCE ,2012,0,0,0,0,0,0,COMPUTER
TOTAL-INDIA,DESTRUCTION OF ELECTRONIC EVIDENCE ,2012,0,11,3,2,0,16,COMPUTER
ANDHRA PRADESH,FORGERY ,2012,0,0,6,0,0,6,COMPUTER
ARUNACHAL PRADESH,FORGERY ,2012,0,0,0,0,0,0,COMPUTER
ASSAM,FORGERY ,2012,0,0,0,0,0,0,COMPUTER
BIHAR,FORGERY ,2012,0,25,9,0,0,34,COMPUTER
CHHATTISGARH,FORGERY ,2012,0,5,0,0,0,5,COMPUTER
GOA,FORGERY ,2012,1,0,1,0,0,2,COMPUTER
GUJARAT,FORGERY ,2012,0,0,0,0,0,0,COMPUTER
HARYANA,FORGERY ,2012,0,9,15,7,4,35,COMPUTER
HIMACHAL PRADESH,FORGERY ,2012,0,0,0,0,0,0,COMPUTER
JAMMU & KASHMIR,FORGERY ,2012,0,0,0,0,0,0,COMPUTER
JHARKHAND,FORGERY ,2012,0,0,0,0,0,0,COMPUTER
KARNATAKA,FORGERY ,2012,0,2,0,0,0,2,COMPUTER
KERALA,FORGERY ,2012,0,10,9,2,0,21,COMPUTER
MADHYA PRADESH,FORGERY ,2012,0,24,3,0,0,27,COMPUTER
MAHARASHTRA,FORGERY ,2012,0,28,25,4,0,57,COMPUTER
MANIPUR,FORGERY ,2012,0,0,0,0,0,0,COMPUTER
MEGHALAYA,FORGERY ,2012,0,0,0,0,0,0,COMPUTER
MIZORAM,FORGERY ,2012,0,0,0,0,0,0,COMPUTER
NAGALAND,FORGERY ,2012,0,0,0,0,0,0,COMPUTER
ORISSA,FORGERY ,2012,0,0,5,0,0,5,COMPUTER
PUNJAB,FORGERY ,2012,0,1,0,0,0,1,COMPUTER
RAJASTHAN,FORGERY ,2012,0,2,1,1,0,4,COMPUTER
SIKKIM,FORGERY ,2012,0,0,0,0,0,0,COMPUTER
TAMIL NADU,FORGERY ,2012,0,0,0,0,0,0,COMPUTER
TRIPURA,FORGERY ,2012,0,0,0,0,0,0,COMPUTER
UTTAR PRADESH,FORGERY ,2012,0,19,28,4,0,51,COMPUTER
UTTARAKHAND,FORGERY ,2012,0,0,0,0,0,0,COMPUTER
WEST BENGAL,FORGERY ,2012,0,5,6,1,0,12,COMPUTER
TOTAL-STATES,FORGERY ,2012,1,130,108,19,4,262,COMPUTER
A & N ISLANDS,FORGERY ,2012,0,0,0,0,0,0,COMPUTER
CHANDIGARH,FORGERY ,2012,0,0,0,0,0,0,COMPUTER
D & N HAVELI,FORGERY ,2012,0,0,0,0,0,0,COMPUTER
DAMAN & DIU,FORGERY ,2012,0,0,0,0,0,0,COMPUTER
DELHI,FORGERY ,2012,0,0,1,0,0,1,COMPUTER
LAKSHADWEEP,FORGERY ,2012,0,0,0,0,0,0,COMPUTER
PUDUCHERRY,FORGERY ,2012,0,0,0,0,0,0,COMPUTER
TOTAL-UTs,FORGERY ,2012,0,0,1,0,0,1,COMPUTER
TOTAL-INDIA,FORGERY ,2012,1,130,109,19,4,263,COMPUTER
ANDHRA PRADESH,CRIMINAL BREACH OF TRUST ,2012,0,2,29,17,0,48,COMPUTER
ARUNACHAL PRADESH,CRIMINAL BREACH OF TRUST ,2012,0,0,0,0,0,0,COMPUTER
ASSAM,CRIMINAL BREACH OF TRUST ,2012,0,0,0,0,0,0,COMPUTER
BIHAR,CRIMINAL BREACH OF TRUST ,2012,0,0,0,0,0,0,COMPUTER
CHHATTISGARH,CRIMINAL BREACH OF TRUST ,2012,0,0,0,0,0,0,COMPUTER
GOA,CRIMINAL BREACH OF TRUST ,2012,0,0,1,0,0,1,COMPUTER
GUJARAT,CRIMINAL BREACH OF TRUST ,2012,0,2,1,2,0,5,COMPUTER
HARYANA,CRIMINAL BREACH OF TRUST ,2012,1,43,27,18,2,91,COMPUTER
HIMACHAL PRADESH,CRIMINAL BREACH OF TRUST ,2012,0,0,0,0,0,0,COMPUTER
JAMMU & KASHMIR,CRIMINAL BREACH OF TRUST ,2012,0,0,0,0,0,0,COMPUTER
JHARKHAND,CRIMINAL BREACH OF TRUST ,2012,0,1,2,0,0,3,COMPUTER
KARNATAKA,CRIMINAL BREACH OF TRUST ,2012,0,0,0,0,0,0,COMPUTER
KERALA,CRIMINAL BREACH OF TRUST ,2012,0,0,1,0,0,1,COMPUTER
MADHYA PRADESH,CRIMINAL BREACH OF TRUST ,2012,0,10,0,1,0,11,COMPUTER
MAHARASHTRA,CRIMINAL BREACH OF TRUST ,2012,0,5,13,4,0,22,COMPUTER
MANIPUR,CRIMINAL BREACH OF TRUST ,2012,0,0,0,0,0,0,COMPUTER
MEGHALAYA,CRIMINAL BREACH OF TRUST ,2012,0,0,0,0,0,0,COMPUTER
MIZORAM,CRIMINAL BREACH OF TRUST ,2012,0,0,0,0,0,0,COMPUTER
NAGALAND,CRIMINAL BREACH OF TRUST ,2012,0,0,0,0,0,0,COMPUTER
ORISSA,CRIMINAL BREACH OF TRUST ,2012,0,0,0,0,0,0,COMPUTER
PUNJAB,CRIMINAL BREACH OF TRUST ,2012,0,1,0,0,0,1,COMPUTER
RAJASTHAN,CRIMINAL BREACH OF TRUST ,2012,0,0,0,0,0,0,COMPUTER
SIKKIM,CRIMINAL BREACH OF TRUST ,2012,0,0,0,0,0,0,COMPUTER
TAMIL NADU,CRIMINAL BREACH OF TRUST ,2012,0,0,0,0,0,0,COMPUTER
TRIPURA,CRIMINAL BREACH OF TRUST ,2012,0,0,0,0,0,0,COMPUTER
UTTAR PRADESH,CRIMINAL BREACH OF TRUST ,2012,0,9,7,0,0,16,COMPUTER
UTTARAKHAND,CRIMINAL BREACH OF TRUST ,2012,0,0,0,0,0,0,COMPUTER
WEST BENGAL,CRIMINAL BREACH OF TRUST ,2012,0,7,5,4,0,16,COMPUTER
TOTAL-STATES,CRIMINAL BREACH OF TRUST ,2012,1,80,86,46,2,215,COMPUTER
A & N ISLANDS,CRIMINAL BREACH OF TRUST ,2012,0,0,0,0,0,0,COMPUTER
CHANDIGARH,CRIMINAL BREACH OF TRUST ,2012,0,0,0,0,0,0,COMPUTER
D & N HAVELI,CRIMINAL BREACH OF TRUST ,2012,0,0,0,0,0,0,COMPUTER
DAMAN & DIU,CRIMINAL BREACH OF TRUST ,2012,0,0,0,0,0,0,COMPUTER
DELHI,CRIMINAL BREACH OF TRUST ,2012,0,0,0,0,0,0,COMPUTER
LAKSHADWEEP,CRIMINAL BREACH OF TRUST ,2012,0,0,0,0,0,0,COMPUTER
PUDUCHERRY,CRIMINAL BREACH OF TRUST ,2012,0,0,0,0,0,0,COMPUTER
TOTAL-UTs,CRIMINAL BREACH OF TRUST ,2012,0,0,0,0,0,0,COMPUTER
TOTAL-INDIA,CRIMINAL BREACH OF TRUST ,2012,1,80,86,46,2,215,COMPUTER
ANDHRA PRADESH,COUNTERFEITING-PROPERTY ,2012,0,0,0,0,0,0,COMPUTER
ARUNACHAL PRADESH,COUNTERFEITING-PROPERTY ,2012,0,0,0,0,0,0,COMPUTER
ASSAM,COUNTERFEITING-PROPERTY ,2012,0,0,0,0,0,0,COMPUTER
BIHAR,COUNTERFEITING-PROPERTY ,2012,0,0,0,0,0,0,COMPUTER
CHHATTISGARH,COUNTERFEITING-PROPERTY ,2012,0,0,0,0,0,0,COMPUTER
GOA,COUNTERFEITING-PROPERTY ,2012,0,0,0,0,0,0,COMPUTER
GUJARAT,COUNTERFEITING-PROPERTY ,2012,0,2,0,1,0,3,COMPUTER
HARYANA,COUNTERFEITING-PROPERTY ,2012,0,0,0,0,0,0,COMPUTER
HIMACHAL PRADESH,COUNTERFEITING-PROPERTY ,2012,0,0,0,0,0,0,COMPUTER
JAMMU & KASHMIR,COUNTERFEITING-PROPERTY ,2012,0,0,0,0,0,0,COMPUTER
JHARKHAND,COUNTERFEITING-PROPERTY ,2012,0,0,0,0,0,0,COMPUTER
KARNATAKA,COUNTERFEITING-PROPERTY ,2012,0,0,0,0,0,0,COMPUTER
KERALA,COUNTERFEITING-PROPERTY ,2012,0,0,0,0,0,0,COMPUTER
MADHYA PRADESH,COUNTERFEITING-PROPERTY ,2012,0,0,0,0,0,0,COMPUTER
MAHARASHTRA,COUNTERFEITING-PROPERTY ,2012,0,0,0,0,0,0,COMPUTER
MANIPUR,COUNTERFEITING-PROPERTY ,2012,0,0,0,0,0,0,COMPUTER
MEGHALAYA,COUNTERFEITING-PROPERTY ,2012,0,0,0,0,0,0,COMPUTER
MIZORAM,COUNTERFEITING-PROPERTY ,2012,0,0,0,0,0,0,COMPUTER
NAGALAND,COUNTERFEITING-PROPERTY ,2012,0,0,0,0,0,0,COMPUTER
ORISSA,COUNTERFEITING-PROPERTY ,2012,0,0,0,0,0,0,COMPUTER
PUNJAB,COUNTERFEITING-PROPERTY ,2012,0,0,0,0,0,0,COMPUTER
RAJASTHAN,COUNTERFEITING-PROPERTY ,2012,0,0,0,0,0,0,COMPUTER
SIKKIM,COUNTERFEITING-PROPERTY ,2012,0,0,0,0,0,0,COMPUTER
TAMIL NADU,COUNTERFEITING-PROPERTY ,2012,0,0,0,0,0,0,COMPUTER
TRIPURA,COUNTERFEITING-PROPERTY ,2012,0,0,0,0,0,0,COMPUTER
UTTAR PRADESH,COUNTERFEITING-PROPERTY ,2012,0,0,0,0,0,0,COMPUTER
UTTARAKHAND,COUNTERFEITING-PROPERTY ,2012,0,0,0,0,0,0,COMPUTER
WEST BENGAL,COUNTERFEITING-PROPERTY ,2012,0,5,3,2,0,10,COMPUTER
TOTAL-STATES,COUNTERFEITING-PROPERTY ,2012,0,7,3,3,0,13,COMPUTER
A & N ISLANDS,COUNTERFEITING-PROPERTY ,2012,0,0,0,0,0,0,COMPUTER
CHANDIGARH,COUNTERFEITING-PROPERTY ,2012,0,0,0,0,0,0,COMPUTER
D & N HAVELI,COUNTERFEITING-PROPERTY ,2012,0,0,0,0,0,0,COMPUTER
DAMAN & DIU,COUNTERFEITING-PROPERTY ,2012,0,0,0,0,0,0,COMPUTER
DELHI,COUNTERFEITING-PROPERTY ,2012,0,0,0,0,0,0,COMPUTER
LAKSHADWEEP,COUNTERFEITING-PROPERTY ,2012,0,0,0,0,0,0,COMPUTER
PUDUCHERRY,COUNTERFEITING-PROPERTY ,2012,0,0,0,0,0,0,COMPUTER
TOTAL-UTs,COUNTERFEITING-PROPERTY ,2012,0,0,0,0,0,0,COMPUTER
TOTAL-INDIA,COUNTERFEITING-PROPERTY ,2012,0,7,3,3,0,13,COMPUTER
ANDHRA PRADESH,COUNTERFEITING-TAMPERING ,2012,0,10,5,0,0,15,COMPUTER
ARUNACHAL PRADESH,COUNTERFEITING-TAMPERING ,2012,0,0,0,0,0,0,COMPUTER
ASSAM,COUNTERFEITING-TAMPERING ,2012,0,0,0,0,0,0,COMPUTER
BIHAR,COUNTERFEITING-TAMPERING ,2012,0,0,0,0,0,0,COMPUTER
CHHATTISGARH,COUNTERFEITING-TAMPERING ,2012,0,0,0,0,0,0,COMPUTER
GOA,COUNTERFEITING-TAMPERING ,2012,0,0,0,0,0,0,COMPUTER
GUJARAT,COUNTERFEITING-TAMPERING ,2012,0,0,0,0,0,0,COMPUTER
HARYANA,COUNTERFEITING-TAMPERING ,2012,0,0,1,0,0,1,COMPUTER
HIMACHAL PRADESH,COUNTERFEITING-TAMPERING ,2012,0,0,0,0,0,0,COMPUTER
JAMMU & KASHMIR,COUNTERFEITING-TAMPERING ,2012,0,0,0,0,0,0,COMPUTER
JHARKHAND,COUNTERFEITING-TAMPERING ,2012,0,0,0,0,0,0,COMPUTER
KARNATAKA,COUNTERFEITING-TAMPERING ,2012,0,5,5,0,0,10,COMPUTER
KERALA,COUNTERFEITING-TAMPERING ,2012,0,0,0,0,0,0,COMPUTER
MADHYA PRADESH,COUNTERFEITING-TAMPERING ,2012,0,0,0,0,0,0,COMPUTER
MAHARASHTRA,COUNTERFEITING-TAMPERING ,2012,0,0,0,0,0,0,COMPUTER
MANIPUR,COUNTERFEITING-TAMPERING ,2012,0,0,0,0,0,0,COMPUTER
MEGHALAYA,COUNTERFEITING-TAMPERING ,2012,0,0,0,0,0,0,COMPUTER
MIZORAM,COUNTERFEITING-TAMPERING ,2012,0,0,0,0,0,0,COMPUTER
NAGALAND,COUNTERFEITING-TAMPERING ,2012,0,0,0,0,0,0,COMPUTER
ORISSA,COUNTERFEITING-TAMPERING ,2012,0,0,0,0,0,0,COMPUTER
PUNJAB,COUNTERFEITING-TAMPERING ,2012,0,0,0,0,0,0,COMPUTER
RAJASTHAN,COUNTERFEITING-TAMPERING ,2012,0,0,0,0,0,0,COMPUTER
SIKKIM,COUNTERFEITING-TAMPERING ,2012,0,0,0,0,0,0,COMPUTER
TAMIL NADU,COUNTERFEITING-TAMPERING ,2012,0,0,0,0,0,0,COMPUTER
TRIPURA,COUNTERFEITING-TAMPERING ,2012,0,0,0,0,0,0,COMPUTER
UTTAR PRADESH,COUNTERFEITING-TAMPERING ,2012,0,0,0,0,0,0,COMPUTER
UTTARAKHAND,COUNTERFEITING-TAMPERING ,2012,0,0,0,0,0,0,COMPUTER
WEST BENGAL,COUNTERFEITING-TAMPERING ,2012,0,0,0,0,0,0,COMPUTER
TOTAL-STATES,COUNTERFEITING-TAMPERING ,2012,0,15,11,0,0,26,COMPUTER
A & N ISLANDS,COUNTERFEITING-TAMPERING ,2012,0,0,0,0,0,0,COMPUTER
CHANDIGARH,COUNTERFEITING-TAMPERING ,2012,0,0,0,0,0,0,COMPUTER
D & N HAVELI,COUNTERFEITING-TAMPERING ,2012,0,0,0,0,0,0,COMPUTER
DAMAN & DIU,COUNTERFEITING-TAMPERING ,2012,0,0,0,0,0,0,COMPUTER
DELHI,COUNTERFEITING-TAMPERING ,2012,0,0,0,0,0,0,COMPUTER
LAKSHADWEEP,COUNTERFEITING-TAMPERING ,2012,0,0,0,0,0,0,COMPUTER
PUDUCHERRY,COUNTERFEITING-TAMPERING ,2012,0,0,0,0,0,0,COMPUTER
TOTAL-UTs,COUNTERFEITING-TAMPERING ,2012,0,0,0,0,0,0,COMPUTER
TOTAL-INDIA,COUNTERFEITING-TAMPERING ,2012,0,15,11,0,0,26,COMPUTER
ANDHRA PRADESH,COUNTERFEITING-CURRENCY,2012,0,0,0,0,0,0,COMPUTER
ARUNACHAL PRADESH,COUNTERFEITING-CURRENCY,2012,0,0,0,0,0,0,COMPUTER
ASSAM,COUNTERFEITING-CURRENCY,2012,0,0,0,0,0,0,COMPUTER
BIHAR,COUNTERFEITING-CURRENCY,2012,0,0,0,0,0,0,COMPUTER
CHHATTISGARH,COUNTERFEITING-CURRENCY,2012,0,0,0,0,0,0,COMPUTER
GOA,COUNTERFEITING-CURRENCY,2012,0,0,0,0,0,0,COMPUTER
GUJARAT,COUNTERFEITING-CURRENCY,2012,0,0,0,0,0,0,COMPUTER
HARYANA,COUNTERFEITING-CURRENCY,2012,0,1,0,0,0,1,COMPUTER
HIMACHAL PRADESH,COUNTERFEITING-CURRENCY,2012,0,0,0,0,0,0,COMPUTER
JAMMU & KASHMIR,COUNTERFEITING-CURRENCY,2012,0,0,0,0,0,0,COMPUTER
JHARKHAND,COUNTERFEITING-CURRENCY,2012,0,0,0,0,0,0,COMPUTER
KARNATAKA,COUNTERFEITING-CURRENCY,2012,0,0,2,0,0,2,COMPUTER
KERALA,COUNTERFEITING-CURRENCY,2012,0,0,0,0,0,0,COMPUTER
MADHYA PRADESH,COUNTERFEITING-CURRENCY,2012,0,2,4,1,0,7,COMPUTER
MAHARASHTRA,COUNTERFEITING-CURRENCY,2012,0,0,0,0,0,0,COMPUTER
MANIPUR,COUNTERFEITING-CURRENCY,2012,0,0,0,0,0,0,COMPUTER
MEGHALAYA,COUNTERFEITING-CURRENCY,2012,0,0,0,0,0,0,COMPUTER
MIZORAM,COUNTERFEITING-CURRENCY,2012,0,0,0,0,0,0,COMPUTER
NAGALAND,COUNTERFEITING-CURRENCY,2012,0,0,0,0,0,0,COMPUTER
ORISSA,COUNTERFEITING-CURRENCY,2012,0,0,0,0,0,0,COMPUTER
PUNJAB,COUNTERFEITING-CURRENCY,2012,0,0,0,0,0,0,COMPUTER
RAJASTHAN,COUNTERFEITING-CURRENCY,2012,0,0,0,0,0,0,COMPUTER
SIKKIM,COUNTERFEITING-CURRENCY,2012,0,0,0,0,0,0,COMPUTER
TAMIL NADU,COUNTERFEITING-CURRENCY,2012,0,0,0,0,0,0,COMPUTER
TRIPURA,COUNTERFEITING-CURRENCY,2012,0,0,0,0,0,0,COMPUTER
UTTAR PRADESH,COUNTERFEITING-CURRENCY,2012,0,0,0,0,0,0,COMPUTER
UTTARAKHAND,COUNTERFEITING-CURRENCY,2012,0,0,0,0,0,0,COMPUTER
WEST BENGAL,COUNTERFEITING-CURRENCY,2012,0,0,0,0,0,0,COMPUTER
TOTAL-STATES,COUNTERFEITING-CURRENCY,2012,0,3,6,1,0,10,COMPUTER
A & N ISLANDS,COUNTERFEITING-CURRENCY,2012,0,0,0,0,0,0,COMPUTER
CHANDIGARH,COUNTERFEITING-CURRENCY,2012,0,0,0,0,0,0,COMPUTER
D & N HAVELI,COUNTERFEITING-CURRENCY,2012,0,0,0,0,0,0,COMPUTER
DAMAN & DIU,COUNTERFEITING-CURRENCY,2012,0,0,0,0,0,0,COMPUTER
DELHI,COUNTERFEITING-CURRENCY,2012,0,0,0,0,0,0,COMPUTER
LAKSHADWEEP,COUNTERFEITING-CURRENCY,2012,0,0,0,0,0,0,COMPUTER
PUDUCHERRY,COUNTERFEITING-CURRENCY,2012,0,0,0,0,0,0,COMPUTER
TOTAL-UTs,COUNTERFEITING-CURRENCY,2012,0,0,0,0,0,0,COMPUTER
TOTAL-INDIA,COUNTERFEITING-CURRENCY,2012,0,3,6,1,0,10,COMPUTER
ANDHRA PRADESH,CYBER-CRIME,2012,0,12,40,17,0,69,COMPUTER
ARUNACHAL PRADESH,CYBER-CRIME,2012,0,0,0,0,0,0,COMPUTER
ASSAM,CYBER-CRIME,2012,0,0,0,0,0,0,COMPUTER
BIHAR,CYBER-CRIME,2012,0,25,9,0,0,34,COMPUTER
CHHATTISGARH,CYBER-CRIME,2012,0,5,0,0,0,5,COMPUTER
GOA,CYBER-CRIME,2012,1,0,2,0,0,3,COMPUTER
GUJARAT,CYBER-CRIME,2012,0,4,1,3,0,8,COMPUTER
HARYANA,CYBER-CRIME,2012,1,60,43,27,6,137,COMPUTER
HIMACHAL PRADESH,CYBER-CRIME,2012,0,0,0,0,0,0,COMPUTER
JAMMU & KASHMIR,CYBER-CRIME,2012,0,0,0,0,0,0,COMPUTER
JHARKHAND,CYBER-CRIME,2012,0,1,2,0,0,3,COMPUTER
KARNATAKA,CYBER-CRIME,2012,0,7,7,0,0,14,COMPUTER
KERALA,CYBER-CRIME,2012,0,11,11,2,0,24,COMPUTER
MADHYA PRADESH,CYBER-CRIME,2012,0,36,7,2,0,45,COMPUTER
MAHARASHTRA,CYBER-CRIME,2012,0,34,40,9,0,83,COMPUTER
MANIPUR,CYBER-CRIME,2012,0,0,0,0,0,0,COMPUTER
MEGHALAYA,CYBER-CRIME,2012,0,0,0,0,0,0,COMPUTER
MIZORAM,CYBER-CRIME,2012,0,0,0,0,0,0,COMPUTER
NAGALAND,CYBER-CRIME,2012,0,0,0,0,0,0,COMPUTER
ORISSA,CYBER-CRIME,2012,0,0,5,0,0,5,COMPUTER
PUNJAB,CYBER-CRIME,2012,0,2,0,0,0,2,COMPUTER
RAJASTHAN,CYBER-CRIME,2012,0,2,1,1,0,4,COMPUTER
SIKKIM,CYBER-CRIME,2012,0,0,0,0,0,0,COMPUTER
TAMIL NADU,CYBER-CRIME,2012,0,0,0,0,0,0,COMPUTER
TRIPURA,CYBER-CRIME,2012,0,0,0,0,0,0,COMPUTER
UTTAR PRADESH,CYBER-CRIME,2012,0,31,38,4,0,73,COMPUTER
UTTARAKHAND,CYBER-CRIME,2012,0,0,0,0,0,0,COMPUTER
WEST BENGAL,CYBER-CRIME,2012,0,18,14,7,0,39,COMPUTER
TOTAL-STATES,CYBER-CRIME,2012,2,248,220,72,6,548,COMPUTER
A & N ISLANDS,CYBER-CRIME,2012,0,0,0,0,0,0,COMPUTER
CHANDIGARH,CYBER-CRIME,2012,0,0,0,0,0,0,COMPUTER
D & N HAVELI,CYBER-CRIME,2012,0,0,0,0,0,0,COMPUTER
DAMAN & DIU,CYBER-CRIME,2012,0,0,0,0,0,0,COMPUTER
DELHI,CYBER-CRIME,2012,0,0,1,0,0,1,COMPUTER
LAKSHADWEEP,CYBER-CRIME,2012,0,0,0,0,0,0,COMPUTER
PUDUCHERRY,CYBER-CRIME,2012,0,0,0,0,0,0,COMPUTER
TOTAL-UTs,CYBER-CRIME,2012,0,0,1,0,0,1,COMPUTER
TOTAL-INDIA,CYBER-CRIME,2012,2,248,221,72,6,549,COMPUTER
ANDHRA PRADESH,TAMPERING DOCUMENTS,2013,0,4,3,1,0,8,COMPUTER
ARUNACHAL PRADESH,TAMPERING DOCUMENTS,2013,0,0,0,0,0,0,COMPUTER
ASSAM,TAMPERING DOCUMENTS,2013,0,0,0,0,0,0,COMPUTER
BIHAR,TAMPERING DOCUMENTS,2013,0,0,0,0,0,0,COMPUTER
CHHATTISGARH,TAMPERING DOCUMENTS,2013,0,0,0,0,0,0,COMPUTER
GOA,TAMPERING DOCUMENTS,2013,0,0,0,0,0,0,COMPUTER
GUJARAT,TAMPERING DOCUMENTS,2013,0,0,4,3,0,7,COMPUTER
HARYANA,TAMPERING DOCUMENTS,2013,0,5,0,0,0,5,COMPUTER
HIMACHAL PRADESH,TAMPERING DOCUMENTS,2013,0,0,0,0,0,0,COMPUTER
JAMMU & KASHMIR,TAMPERING DOCUMENTS,2013,0,0,0,0,0,0,COMPUTER
JHARKHAND,TAMPERING DOCUMENTS,2013,0,0,0,0,0,0,COMPUTER
KARNATAKA,TAMPERING DOCUMENTS,2013,0,1,0,0,0,1,COMPUTER
KERALA,TAMPERING DOCUMENTS,2013,0,3,2,0,0,5,COMPUTER
MADHYA PRADESH,TAMPERING DOCUMENTS,2013,0,0,1,4,0,5,COMPUTER
MAHARASHTRA,TAMPERING DOCUMENTS,2013,0,2,0,0,0,2,COMPUTER
MANIPUR,TAMPERING DOCUMENTS,2013,0,0,0,0,0,0,COMPUTER
MEGHALAYA,TAMPERING DOCUMENTS,2013,0,0,0,0,0,0,COMPUTER
MIZORAM,TAMPERING DOCUMENTS,2013,0,0,0,0,0,0,COMPUTER
NAGALAND,TAMPERING DOCUMENTS,2013,0,0,0,0,0,0,COMPUTER
ORISSA,TAMPERING DOCUMENTS,2013,0,3,0,0,0,3,COMPUTER
PUNJAB,TAMPERING DOCUMENTS,2013,0,0,0,0,0,0,COMPUTER
RAJASTHAN,TAMPERING DOCUMENTS,2013,1,0,2,0,0,3,COMPUTER
SIKKIM,TAMPERING DOCUMENTS,2013,0,0,0,0,0,0,COMPUTER
TAMIL NADU,TAMPERING DOCUMENTS,2013,0,0,2,0,0,2,COMPUTER
TRIPURA,TAMPERING DOCUMENTS,2013,0,0,0,0,0,0,COMPUTER
UTTAR PRADESH,TAMPERING DOCUMENTS,2013,0,2,0,0,0,2,COMPUTER
UTTARAKHAND,TAMPERING DOCUMENTS,2013,0,0,0,0,0,0,COMPUTER
WEST BENGAL,TAMPERING DOCUMENTS,2013,0,3,10,3,0,16,COMPUTER
TOT (STATES),TAMPERING DOCUMENTS,2013,1,23,24,11,0,59,COMPUTER
A & N ISLANDS,TAMPERING DOCUMENTS,2013,0,0,0,0,0,0,COMPUTER
CHANDIGARH,TAMPERING DOCUMENTS,2013,0,0,0,0,0,0,COMPUTER
D & N HAVELI,TAMPERING DOCUMENTS,2013,0,0,0,0,0,0,COMPUTER
DAMAN & DIU,TAMPERING DOCUMENTS,2013,0,0,0,0,0,0,COMPUTER
DELHI,TAMPERING DOCUMENTS,2013,0,0,0,0,0,0,COMPUTER
LAKSHADWEEP,TAMPERING DOCUMENTS,2013,0,0,0,0,0,0,COMPUTER
PUDUCHERRY,TAMPERING DOCUMENTS,2013,0,0,0,0,0,0,COMPUTER
TOT (UTS),TAMPERING DOCUMENTS,2013,0,0,0,0,0,0,COMPUTER
TOT (ALL INDIA),TAMPERING DOCUMENTS,2013,1,23,24,11,0,59,COMPUTER
ANDHRA PRADESH,LOSS OR DAMAGE,2013,1,92,59,7,0,159,COMPUTER
ARUNACHAL PRADESH,LOSS OR DAMAGE,2013,0,0,2,0,0,2,COMPUTER
ASSAM,LOSS OR DAMAGE,2013,0,0,0,0,0,0,COMPUTER
BIHAR,LOSS OR DAMAGE,2013,0,14,6,0,0,20,COMPUTER
CHHATTISGARH,LOSS OR DAMAGE,2013,0,12,13,0,0,25,COMPUTER
GOA,LOSS OR DAMAGE,2013,0,0,0,0,0,0,COMPUTER
GUJARAT,LOSS OR DAMAGE,2013,0,13,5,1,1,20,COMPUTER
HARYANA,LOSS OR DAMAGE,2013,1,19,19,1,0,40,COMPUTER
HIMACHAL PRADESH,LOSS OR DAMAGE,2013,0,3,0,0,0,3,COMPUTER
JAMMU & KASHMIR,LOSS OR DAMAGE,2013,0,1,0,0,0,1,COMPUTER
JHARKHAND,LOSS OR DAMAGE,2013,0,1,0,0,0,1,COMPUTER
KARNATAKA,LOSS OR DAMAGE,2013,0,13,15,2,0,30,COMPUTER
KERALA,LOSS OR DAMAGE,2013,0,14,4,2,0,20,COMPUTER
MADHYA PRADESH,LOSS OR DAMAGE,2013,2,80,37,8,1,128,COMPUTER
MAHARASHTRA,LOSS OR DAMAGE,2013,2,43,51,5,0,101,COMPUTER
MANIPUR,LOSS OR DAMAGE,2013,0,0,0,0,0,0,COMPUTER
MEGHALAYA,LOSS OR DAMAGE,2013,0,0,0,0,0,0,COMPUTER
MIZORAM,LOSS OR DAMAGE,2013,0,0,0,0,0,0,COMPUTER
NAGALAND,LOSS OR DAMAGE,2013,0,0,0,0,0,0,COMPUTER
ORISSA,LOSS OR DAMAGE,2013,0,4,5,0,0,9,COMPUTER
PUNJAB,LOSS OR DAMAGE,2013,2,35,39,0,0,76,COMPUTER
RAJASTHAN,LOSS OR DAMAGE,2013,1,27,13,3,0,44,COMPUTER
SIKKIM,LOSS OR DAMAGE,2013,0,0,0,0,0,0,COMPUTER
TAMIL NADU,LOSS OR DAMAGE,2013,0,13,10,11,1,35,COMPUTER
TRIPURA,LOSS OR DAMAGE,2013,1,6,1,0,0,8,COMPUTER
UTTAR PRADESH,LOSS OR DAMAGE,2013,0,38,10,0,0,48,COMPUTER
UTTARAKHAND,LOSS OR DAMAGE,2013,0,0,0,0,0,0,COMPUTER
WEST BENGAL,LOSS OR DAMAGE,2013,0,12,9,1,0,22,COMPUTER
TOT (STATES),LOSS OR DAMAGE,2013,10,440,298,41,3,792,COMPUTER
A & N ISLANDS,LOSS OR DAMAGE,2013,0,3,0,0,0,3,COMPUTER
CHANDIGARH,LOSS OR DAMAGE,2013,0,0,0,0,0,0,COMPUTER
D & N HAVELI,LOSS OR DAMAGE,2013,0,0,0,0,0,0,COMPUTER
DAMAN & DIU,LOSS OR DAMAGE,2013,0,0,0,0,0,0,COMPUTER
DELHI,LOSS OR DAMAGE,2013,0,11,9,3,0,23,COMPUTER
LAKSHADWEEP,LOSS OR DAMAGE,2013,0,0,0,0,0,0,COMPUTER
PUDUCHERRY,LOSS OR DAMAGE,2013,0,0,0,0,0,0,COMPUTER
TOT (UTS),LOSS OR DAMAGE,2013,0,14,9,3,0,26,COMPUTER
TOT (ALL INDIA),LOSS OR DAMAGE,2013,10,454,307,44,3,818,COMPUTER
ANDHRA PRADESH,HACKING ,2013,1,9,1,0,0,11,COMPUTER
ARUNACHAL PRADESH,HACKING ,2013,0,0,0,0,0,0,COMPUTER
ASSAM,HACKING ,2013,0,0,0,0,0,0,COMPUTER
BIHAR,HACKING ,2013,0,0,0,0,0,0,COMPUTER
CHHATTISGARH,HACKING ,2013,0,3,3,0,0,6,COMPUTER
GOA,HACKING ,2013,0,0,0,0,0,0,COMPUTER
GUJARAT,HACKING ,2013,0,11,3,2,0,16,COMPUTER
HARYANA,HACKING ,2013,0,0,4,2,1,7,COMPUTER
HIMACHAL PRADESH,HACKING ,2013,0,0,1,0,0,1,COMPUTER
JAMMU & KASHMIR,HACKING ,2013,0,1,0,0,0,1,COMPUTER
JHARKHAND,HACKING ,2013,0,0,0,0,0,0,COMPUTER
KARNATAKA,HACKING ,2013,0,19,25,0,0,44,COMPUTER
KERALA,HACKING ,2013,0,4,4,0,0,8,COMPUTER
MADHYA PRADESH,HACKING ,2013,0,3,2,1,1,7,COMPUTER
MAHARASHTRA,HACKING ,2013,1,5,11,0,0,17,COMPUTER
MANIPUR,HACKING ,2013,0,0,0,0,0,0,COMPUTER
MEGHALAYA,HACKING ,2013,0,0,0,0,0,0,COMPUTER
MIZORAM,HACKING ,2013,0,0,0,0,0,0,COMPUTER
NAGALAND,HACKING ,2013,0,0,0,0,0,0,COMPUTER
ORISSA,HACKING ,2013,0,0,12,0,0,12,COMPUTER
PUNJAB,HACKING ,2013,0,6,7,1,0,14,COMPUTER
RAJASTHAN,HACKING ,2013,0,2,4,0,0,6,COMPUTER
SIKKIM,HACKING ,2013,0,0,0,0,0,0,COMPUTER
TAMIL NADU,HACKING ,2013,0,2,0,0,0,2,COMPUTER
TRIPURA,HACKING ,2013,0,0,0,0,0,0,COMPUTER
UTTAR PRADESH,HACKING ,2013,0,10,6,0,0,16,COMPUTER
UTTARAKHAND,HACKING ,2013,0,0,0,0,0,0,COMPUTER
WEST BENGAL,HACKING ,2013,0,6,2,0,0,8,COMPUTER
TOT (STATES),HACKING ,2013,2,81,85,6,2,176,COMPUTER
A & N ISLANDS,HACKING ,2013,0,0,0,0,0,0,COMPUTER
CHANDIGARH,HACKING ,2013,0,6,0,0,0,6,COMPUTER
D & N HAVELI,HACKING ,2013,0,0,0,0,0,0,COMPUTER
DAMAN & DIU,HACKING ,2013,0,0,2,0,0,2,COMPUTER
DELHI,HACKING ,2013,0,5,3,0,0,8,COMPUTER
LAKSHADWEEP,HACKING ,2013,0,0,0,0,0,0,COMPUTER
PUDUCHERRY,HACKING ,2013,0,0,1,0,0,1,COMPUTER
TOT (UTS),HACKING ,2013,0,11,6,0,0,17,COMPUTER
TOT (ALL INDIA),HACKING ,2013,2,92,91,6,2,193,COMPUTER
ANDHRA PRADESH,TRANSMISSION IN ELECTRONIC FORM ,2013,7,70,30,0,0,107,COMPUTER
ARUNACHAL PRADESH,TRANSMISSION IN ELECTRONIC FORM ,2013,0,0,3,0,0,3,COMPUTER
ASSAM,TRANSMISSION IN ELECTRONIC FORM ,2013,0,2,0,0,0,2,COMPUTER
BIHAR,TRANSMISSION IN ELECTRONIC FORM ,2013,0,2,0,0,0,2,COMPUTER
CHHATTISGARH,TRANSMISSION IN ELECTRONIC FORM ,2013,0,4,0,0,0,4,COMPUTER
GOA,TRANSMISSION IN ELECTRONIC FORM ,2013,0,4,4,2,0,10,COMPUTER
GUJARAT,TRANSMISSION IN ELECTRONIC FORM ,2013,0,4,2,2,0,8,COMPUTER
HARYANA,TRANSMISSION IN ELECTRONIC FORM ,2013,0,5,1,0,0,6,COMPUTER
HIMACHAL PRADESH,TRANSMISSION IN ELECTRONIC FORM ,2013,0,6,3,0,0,9,COMPUTER
JAMMU & KASHMIR,TRANSMISSION IN ELECTRONIC FORM ,2013,0,1,2,1,0,4,COMPUTER
JHARKHAND,TRANSMISSION IN ELECTRONIC FORM ,2013,0,2,0,0,0,2,COMPUTER
KARNATAKA,TRANSMISSION IN ELECTRONIC FORM ,2013,0,12,3,1,1,17,COMPUTER
KERALA,TRANSMISSION IN ELECTRONIC FORM ,2013,9,47,38,13,0,107,COMPUTER
MADHYA PRADESH,TRANSMISSION IN ELECTRONIC FORM ,2013,0,21,4,0,0,25,COMPUTER
MAHARASHTRA,TRANSMISSION IN ELECTRONIC FORM ,2013,2,66,44,16,2,130,COMPUTER
MANIPUR,TRANSMISSION IN ELECTRONIC FORM ,2013,0,0,0,0,0,0,COMPUTER
MEGHALAYA,TRANSMISSION IN ELECTRONIC FORM ,2013,0,0,0,0,0,0,COMPUTER
MIZORAM,TRANSMISSION IN ELECTRONIC FORM ,2013,0,0,0,0,0,0,COMPUTER
NAGALAND,TRANSMISSION IN ELECTRONIC FORM ,2013,0,0,0,0,0,0,COMPUTER
ORISSA,TRANSMISSION IN ELECTRONIC FORM ,2013,0,1,1,0,0,2,COMPUTER
PUNJAB,TRANSMISSION IN ELECTRONIC FORM ,2013,2,15,8,2,1,28,COMPUTER
RAJASTHAN,TRANSMISSION IN ELECTRONIC FORM ,2013,0,50,22,8,0,80,COMPUTER
SIKKIM,TRANSMISSION IN ELECTRONIC FORM ,2013,0,0,0,0,0,0,COMPUTER
TAMIL NADU,TRANSMISSION IN ELECTRONIC FORM ,2013,0,3,0,1,0,4,COMPUTER
TRIPURA,TRANSMISSION IN ELECTRONIC FORM ,2013,0,4,1,0,0,5,COMPUTER
UTTAR PRADESH,TRANSMISSION IN ELECTRONIC FORM ,2013,0,130,32,5,0,167,COMPUTER
UTTARAKHAND,TRANSMISSION IN ELECTRONIC FORM ,2013,0,2,1,0,0,3,COMPUTER
WEST BENGAL,TRANSMISSION IN ELECTRONIC FORM ,2013,0,5,4,1,0,10,COMPUTER
TOT (STATES),TRANSMISSION IN ELECTRONIC FORM ,2013,20,456,203,52,4,735,COMPUTER
A & N ISLANDS,TRANSMISSION IN ELECTRONIC FORM ,2013,0,0,0,0,0,0,COMPUTER
CHANDIGARH,TRANSMISSION IN ELECTRONIC FORM ,2013,0,1,0,0,0,1,COMPUTER
D & N HAVELI,TRANSMISSION IN ELECTRONIC FORM ,2013,0,0,0,0,0,0,COMPUTER
DAMAN & DIU,TRANSMISSION IN ELECTRONIC FORM ,2013,0,0,0,0,0,0,COMPUTER
DELHI,TRANSMISSION IN ELECTRONIC FORM ,2013,0,0,0,0,0,0,COMPUTER
LAKSHADWEEP,TRANSMISSION IN ELECTRONIC FORM ,2013,0,0,0,0,0,0,COMPUTER
PUDUCHERRY,TRANSMISSION IN ELECTRONIC FORM ,2013,0,0,0,1,0,1,COMPUTER
TOT (UTS),TRANSMISSION IN ELECTRONIC FORM ,2013,0,1,0,1,0,2,COMPUTER
TOT (ALL INDIA),TRANSMISSION IN ELECTRONIC FORM ,2013,20,457,203,53,4,737,COMPUTER
ANDHRA PRADESH,FAILURE - OF COMPLIANCE ,2013,0,0,0,0,0,0,COMPUTER
ARUNACHAL PRADESH,FAILURE - OF COMPLIANCE ,2013,0,0,0,0,0,0,COMPUTER
ASSAM,FAILURE - OF COMPLIANCE ,2013,0,0,0,0,0,0,COMPUTER
BIHAR,FAILURE - OF COMPLIANCE ,2013,0,0,0,0,0,0,COMPUTER
CHHATTISGARH,FAILURE - OF COMPLIANCE ,2013,0,0,0,0,0,0,COMPUTER
GOA,FAILURE - OF COMPLIANCE ,2013,0,0,0,0,0,0,COMPUTER
GUJARAT,FAILURE - OF COMPLIANCE ,2013,0,0,0,0,0,0,COMPUTER
HARYANA,FAILURE - OF COMPLIANCE ,2013,0,0,0,0,0,0,COMPUTER
HIMACHAL PRADESH,FAILURE - OF COMPLIANCE ,2013,0,0,0,0,0,0,COMPUTER
JAMMU & KASHMIR,FAILURE - OF COMPLIANCE ,2013,0,0,0,0,0,0,COMPUTER
JHARKHAND,FAILURE - OF COMPLIANCE ,2013,0,0,0,0,0,0,COMPUTER
KARNATAKA,FAILURE - OF COMPLIANCE ,2013,0,0,0,0,0,0,COMPUTER
KERALA,FAILURE - OF COMPLIANCE ,2013,0,1,2,0,0,3,COMPUTER
MADHYA PRADESH,FAILURE - OF COMPLIANCE ,2013,0,0,0,0,0,0,COMPUTER
MAHARASHTRA,FAILURE - OF COMPLIANCE ,2013,0,0,0,0,0,0,COMPUTER
MANIPUR,FAILURE - OF COMPLIANCE ,2013,0,0,0,0,0,0,COMPUTER
MEGHALAYA,FAILURE - OF COMPLIANCE ,2013,0,0,0,0,0,0,COMPUTER
MIZORAM,FAILURE - OF COMPLIANCE ,2013,0,0,0,0,0,0,COMPUTER
NAGALAND,FAILURE - OF COMPLIANCE ,2013,0,0,0,0,0,0,COMPUTER
ORISSA,FAILURE - OF COMPLIANCE ,2013,0,0,0,0,0,0,COMPUTER
PUNJAB,FAILURE - OF COMPLIANCE ,2013,0,0,0,0,0,0,COMPUTER
RAJASTHAN,FAILURE - OF COMPLIANCE ,2013,0,0,0,0,0,0,COMPUTER
SIKKIM,FAILURE - OF COMPLIANCE ,2013,0,0,0,0,0,0,COMPUTER
TAMIL NADU,FAILURE - OF COMPLIANCE ,2013,0,0,0,0,0,0,COMPUTER
TRIPURA,FAILURE - OF COMPLIANCE ,2013,0,0,0,0,0,0,COMPUTER
UTTAR PRADESH,FAILURE - OF COMPLIANCE ,2013,0,0,0,0,0,0,COMPUTER
UTTARAKHAND,FAILURE - OF COMPLIANCE ,2013,0,0,0,0,0,0,COMPUTER
WEST BENGAL,FAILURE - OF COMPLIANCE ,2013,0,0,0,0,0,0,COMPUTER
TOT (STATES),FAILURE - OF COMPLIANCE ,2013,0,1,2,0,0,3,COMPUTER
A & N ISLANDS,FAILURE - OF COMPLIANCE ,2013,0,0,0,0,0,0,COMPUTER
CHANDIGARH,FAILURE - OF COMPLIANCE ,2013,0,0,0,0,0,0,COMPUTER
D & N HAVELI,FAILURE - OF COMPLIANCE ,2013,0,0,0,0,0,0,COMPUTER
DAMAN & DIU,FAILURE - OF COMPLIANCE ,2013,0,0,0,0,0,0,COMPUTER
DELHI,FAILURE - OF COMPLIANCE ,2013,0,0,0,0,0,0,COMPUTER
LAKSHADWEEP,FAILURE - OF COMPLIANCE ,2013,0,0,0,0,0,0,COMPUTER
PUDUCHERRY,FAILURE - OF COMPLIANCE ,2013,0,0,0,0,0,0,COMPUTER
TOT (UTS),FAILURE - OF COMPLIANCE ,2013,0,0,0,0,0,0,COMPUTER
TOT (ALL INDIA),FAILURE - OF COMPLIANCE ,2013,0,1,2,0,0,3,COMPUTER
ANDHRA PRADESH,FAILURE - TO ASSIST IN DECRYPTING THE INFORMATION INTERCEPTED BY GOVT AGENCY ,2013,0,0,0,0,0,0,COMPUTER
ARUNACHAL PRADESH,FAILURE - TO ASSIST IN DECRYPTING THE INFORMATION INTERCEPTED BY GOVT AGENCY ,2013,0,0,0,0,0,0,COMPUTER
ASSAM,FAILURE - TO ASSIST IN DECRYPTING THE INFORMATION INTERCEPTED BY GOVT AGENCY ,2013,0,0,0,0,0,0,COMPUTER
BIHAR,FAILURE - TO ASSIST IN DECRYPTING THE INFORMATION INTERCEPTED BY GOVT AGENCY ,2013,0,0,0,0,0,0,COMPUTER
CHHATTISGARH,FAILURE - TO ASSIST IN DECRYPTING THE INFORMATION INTERCEPTED BY GOVT AGENCY ,2013,0,0,0,0,0,0,COMPUTER
GOA,FAILURE - TO ASSIST IN DECRYPTING THE INFORMATION INTERCEPTED BY GOVT AGENCY ,2013,0,0,0,0,0,0,COMPUTER
GUJARAT,FAILURE - TO ASSIST IN DECRYPTING THE INFORMATION INTERCEPTED BY GOVT AGENCY ,2013,0,0,0,0,0,0,COMPUTER
HARYANA,FAILURE - TO ASSIST IN DECRYPTING THE INFORMATION INTERCEPTED BY GOVT AGENCY ,2013,0,0,0,0,0,0,COMPUTER
HIMACHAL PRADESH,FAILURE - TO ASSIST IN DECRYPTING THE INFORMATION INTERCEPTED BY GOVT AGENCY ,2013,0,0,0,0,0,0,COMPUTER
JAMMU & KASHMIR,FAILURE - TO ASSIST IN DECRYPTING THE INFORMATION INTERCEPTED BY GOVT AGENCY ,2013,0,0,0,0,0,0,COMPUTER
JHARKHAND,FAILURE - TO ASSIST IN DECRYPTING THE INFORMATION INTERCEPTED BY GOVT AGENCY ,2013,0,0,0,0,0,0,COMPUTER
KARNATAKA,FAILURE - TO ASSIST IN DECRYPTING THE INFORMATION INTERCEPTED BY GOVT AGENCY ,2013,0,0,0,0,0,0,COMPUTER
KERALA,FAILURE - TO ASSIST IN DECRYPTING THE INFORMATION INTERCEPTED BY GOVT AGENCY ,2013,0,0,0,0,0,0,COMPUTER
MADHYA PRADESH,FAILURE - TO ASSIST IN DECRYPTING THE INFORMATION INTERCEPTED BY GOVT AGENCY ,2013,0,0,0,0,0,0,COMPUTER
MAHARASHTRA,FAILURE - TO ASSIST IN DECRYPTING THE INFORMATION INTERCEPTED BY GOVT AGENCY ,2013,3,4,0,0,0,7,COMPUTER
MANIPUR,FAILURE - TO ASSIST IN DECRYPTING THE INFORMATION INTERCEPTED BY GOVT AGENCY ,2013,0,0,0,0,0,0,COMPUTER
MEGHALAYA,FAILURE - TO ASSIST IN DECRYPTING THE INFORMATION INTERCEPTED BY GOVT AGENCY ,2013,0,0,0,0,0,0,COMPUTER
MIZORAM,FAILURE - TO ASSIST IN DECRYPTING THE INFORMATION INTERCEPTED BY GOVT AGENCY ,2013,0,0,0,0,0,0,COMPUTER
NAGALAND,FAILURE - TO ASSIST IN DECRYPTING THE INFORMATION INTERCEPTED BY GOVT AGENCY ,2013,0,0,0,0,0,0,COMPUTER
ORISSA,FAILURE - TO ASSIST IN DECRYPTING THE INFORMATION INTERCEPTED BY GOVT AGENCY ,2013,0,0,0,0,0,0,COMPUTER
PUNJAB,FAILURE - TO ASSIST IN DECRYPTING THE INFORMATION INTERCEPTED BY GOVT AGENCY ,2013,0,0,0,0,0,0,COMPUTER
RAJASTHAN,FAILURE - TO ASSIST IN DECRYPTING THE INFORMATION INTERCEPTED BY GOVT AGENCY ,2013,0,0,0,0,0,0,COMPUTER
SIKKIM,FAILURE - TO ASSIST IN DECRYPTING THE INFORMATION INTERCEPTED BY GOVT AGENCY ,2013,0,0,0,0,0,0,COMPUTER
TAMIL NADU,FAILURE - TO ASSIST IN DECRYPTING THE INFORMATION INTERCEPTED BY GOVT AGENCY ,2013,0,0,0,0,0,0,COMPUTER
TRIPURA,FAILURE - TO ASSIST IN DECRYPTING THE INFORMATION INTERCEPTED BY GOVT AGENCY ,2013,0,0,0,0,0,0,COMPUTER
UTTAR PRADESH,FAILURE - TO ASSIST IN DECRYPTING THE INFORMATION INTERCEPTED BY GOVT AGENCY ,2013,0,0,0,0,0,0,COMPUTER
UTTARAKHAND,FAILURE - TO ASSIST IN DECRYPTING THE INFORMATION INTERCEPTED BY GOVT AGENCY ,2013,0,0,0,0,0,0,COMPUTER
WEST BENGAL,FAILURE - TO ASSIST IN DECRYPTING THE INFORMATION INTERCEPTED BY GOVT AGENCY ,2013,0,0,0,0,0,0,COMPUTER
TOT (STATES),FAILURE - TO ASSIST IN DECRYPTING THE INFORMATION INTERCEPTED BY GOVT AGENCY ,2013,3,4,0,0,0,7,COMPUTER
A & N ISLANDS,FAILURE - TO ASSIST IN DECRYPTING THE INFORMATION INTERCEPTED BY GOVT AGENCY ,2013,0,0,0,0,0,0,COMPUTER
CHANDIGARH,FAILURE - TO ASSIST IN DECRYPTING THE INFORMATION INTERCEPTED BY GOVT AGENCY ,2013,0,0,0,0,0,0,COMPUTER
D & N HAVELI,FAILURE - TO ASSIST IN DECRYPTING THE INFORMATION INTERCEPTED BY GOVT AGENCY ,2013,0,0,0,0,0,0,COMPUTER
DAMAN & DIU,FAILURE - TO ASSIST IN DECRYPTING THE INFORMATION INTERCEPTED BY GOVT AGENCY ,2013,0,0,0,0,0,0,COMPUTER
DELHI,FAILURE - TO ASSIST IN DECRYPTING THE INFORMATION INTERCEPTED BY GOVT AGENCY ,2013,0,0,0,0,0,0,COMPUTER
LAKSHADWEEP,FAILURE - TO ASSIST IN DECRYPTING THE INFORMATION INTERCEPTED BY GOVT AGENCY ,2013,0,0,0,0,0,0,COMPUTER
PUDUCHERRY,FAILURE - TO ASSIST IN DECRYPTING THE INFORMATION INTERCEPTED BY GOVT AGENCY ,2013,0,0,0,0,0,0,COMPUTER
TOT (UTS),FAILURE - TO ASSIST IN DECRYPTING THE INFORMATION INTERCEPTED BY GOVT AGENCY ,2013,0,0,0,0,0,0,COMPUTER
TOT (ALL INDIA),FAILURE - TO ASSIST IN DECRYPTING THE INFORMATION INTERCEPTED BY GOVT AGENCY ,2013,3,4,0,0,0,7,COMPUTER
ANDHRA PRADESH,UN-AUTHORISED ACCESS ,2013,0,0,0,0,0,0,COMPUTER
ARUNACHAL PRADESH,UN-AUTHORISED ACCESS ,2013,0,0,0,0,0,0,COMPUTER
ASSAM,UN-AUTHORISED ACCESS ,2013,0,0,0,0,0,0,COMPUTER
BIHAR,UN-AUTHORISED ACCESS ,2013,0,0,0,0,0,0,COMPUTER
CHHATTISGARH,UN-AUTHORISED ACCESS ,2013,0,0,0,0,0,0,COMPUTER
GOA,UN-AUTHORISED ACCESS ,2013,0,0,0,0,0,0,COMPUTER
GUJARAT,UN-AUTHORISED ACCESS ,2013,0,0,0,0,0,0,COMPUTER
HARYANA,UN-AUTHORISED ACCESS ,2013,0,0,0,0,0,0,COMPUTER
HIMACHAL PRADESH,UN-AUTHORISED ACCESS ,2013,0,0,0,0,0,0,COMPUTER
JAMMU & KASHMIR,UN-AUTHORISED ACCESS ,2013,0,0,0,0,0,0,COMPUTER
JHARKHAND,UN-AUTHORISED ACCESS ,2013,0,0,0,0,0,0,COMPUTER
KARNATAKA,UN-AUTHORISED ACCESS ,2013,0,0,0,0,0,0,COMPUTER
KERALA,UN-AUTHORISED ACCESS ,2013,0,0,0,0,0,0,COMPUTER
MADHYA PRADESH,UN-AUTHORISED ACCESS ,2013,0,0,0,0,0,0,COMPUTER
MAHARASHTRA,UN-AUTHORISED ACCESS ,2013,0,0,0,0,0,0,COMPUTER
MANIPUR,UN-AUTHORISED ACCESS ,2013,0,0,0,0,0,0,COMPUTER
MEGHALAYA,UN-AUTHORISED ACCESS ,2013,0,0,0,0,0,0,COMPUTER
MIZORAM,UN-AUTHORISED ACCESS ,2013,0,0,0,0,0,0,COMPUTER
NAGALAND,UN-AUTHORISED ACCESS ,2013,0,0,0,0,0,0,COMPUTER
ORISSA,UN-AUTHORISED ACCESS ,2013,0,0,0,0,0,0,COMPUTER
PUNJAB,UN-AUTHORISED ACCESS ,2013,0,0,0,0,0,0,COMPUTER
RAJASTHAN,UN-AUTHORISED ACCESS ,2013,0,0,0,0,0,0,COMPUTER
SIKKIM,UN-AUTHORISED ACCESS ,2013,0,0,0,0,0,0,COMPUTER
TAMIL NADU,UN-AUTHORISED ACCESS ,2013,0,0,0,0,0,0,COMPUTER
TRIPURA,UN-AUTHORISED ACCESS ,2013,0,0,0,0,0,0,COMPUTER
UTTAR PRADESH,UN-AUTHORISED ACCESS ,2013,0,9,8,0,0,17,COMPUTER
UTTARAKHAND,UN-AUTHORISED ACCESS ,2013,0,0,0,0,0,0,COMPUTER
WEST BENGAL,UN-AUTHORISED ACCESS ,2013,0,0,0,0,0,0,COMPUTER
TOT (STATES),UN-AUTHORISED ACCESS ,2013,0,9,8,0,0,17,COMPUTER
A & N ISLANDS,UN-AUTHORISED ACCESS ,2013,0,0,0,0,0,0,COMPUTER
CHANDIGARH,UN-AUTHORISED ACCESS ,2013,0,0,0,0,0,0,COMPUTER
D & N HAVELI,UN-AUTHORISED ACCESS ,2013,0,0,0,0,0,0,COMPUTER
DAMAN & DIU,UN-AUTHORISED ACCESS ,2013,0,0,0,0,0,0,COMPUTER
DELHI,UN-AUTHORISED ACCESS ,2013,0,0,0,0,0,0,COMPUTER
LAKSHADWEEP,UN-AUTHORISED ACCESS ,2013,0,0,0,0,0,0,COMPUTER
PUDUCHERRY,UN-AUTHORISED ACCESS ,2013,0,0,0,0,0,0,COMPUTER
TOT (UTS),UN-AUTHORISED ACCESS ,2013,0,0,0,0,0,0,COMPUTER
TOT (ALL INDIA),UN-AUTHORISED ACCESS ,2013,0,9,8,0,0,17,COMPUTER
ANDHRA PRADESH,OBTAINING LICENCE BY MISREPRESENTATION OF FACT ,2013,0,0,0,0,0,0,COMPUTER
ARUNACHAL PRADESH,OBTAINING LICENCE BY MISREPRESENTATION OF FACT ,2013,0,0,0,0,0,0,COMPUTER
ASSAM,OBTAINING LICENCE BY MISREPRESENTATION OF FACT ,2013,0,0,0,0,0,0,COMPUTER
BIHAR,OBTAINING LICENCE BY MISREPRESENTATION OF FACT ,2013,0,0,0,0,0,0,COMPUTER
CHHATTISGARH,OBTAINING LICENCE BY MISREPRESENTATION OF FACT ,2013,0,0,0,0,0,0,COMPUTER
GOA,OBTAINING LICENCE BY MISREPRESENTATION OF FACT ,2013,0,0,0,0,0,0,COMPUTER
GUJARAT,OBTAINING LICENCE BY MISREPRESENTATION OF FACT ,2013,0,0,0,0,0,0,COMPUTER
HARYANA,OBTAINING LICENCE BY MISREPRESENTATION OF FACT ,2013,0,0,0,0,0,0,COMPUTER
HIMACHAL PRADESH,OBTAINING LICENCE BY MISREPRESENTATION OF FACT ,2013,0,0,0,0,0,0,COMPUTER
JAMMU & KASHMIR,OBTAINING LICENCE BY MISREPRESENTATION OF FACT ,2013,0,0,0,0,0,0,COMPUTER
JHARKHAND,OBTAINING LICENCE BY MISREPRESENTATION OF FACT ,2013,0,0,0,0,0,0,COMPUTER
KARNATAKA,OBTAINING LICENCE BY MISREPRESENTATION OF FACT ,2013,0,0,0,0,0,0,COMPUTER
KERALA,OBTAINING LICENCE BY MISREPRESENTATION OF FACT ,2013,0,0,0,0,0,0,COMPUTER
MADHYA PRADESH,OBTAINING LICENCE BY MISREPRESENTATION OF FACT ,2013,0,0,0,0,0,0,COMPUTER
MAHARASHTRA,OBTAINING LICENCE BY MISREPRESENTATION OF FACT ,2013,0,7,3,0,0,10,COMPUTER
MANIPUR,OBTAINING LICENCE BY MISREPRESENTATION OF FACT ,2013,0,0,0,0,0,0,COMPUTER
MEGHALAYA,OBTAINING LICENCE BY MISREPRESENTATION OF FACT ,2013,0,0,0,0,0,0,COMPUTER
MIZORAM,OBTAINING LICENCE BY MISREPRESENTATION OF FACT ,2013,0,0,0,0,0,0,COMPUTER
NAGALAND,OBTAINING LICENCE BY MISREPRESENTATION OF FACT ,2013,0,0,0,0,0,0,COMPUTER
ORISSA,OBTAINING LICENCE BY MISREPRESENTATION OF FACT ,2013,0,0,0,0,0,0,COMPUTER
PUNJAB,OBTAINING LICENCE BY MISREPRESENTATION OF FACT ,2013,0,0,1,0,0,1,COMPUTER
RAJASTHAN,OBTAINING LICENCE BY MISREPRESENTATION OF FACT ,2013,0,0,0,0,0,0,COMPUTER
SIKKIM,OBTAINING LICENCE BY MISREPRESENTATION OF FACT ,2013,0,0,0,0,0,0,COMPUTER
TAMIL NADU,OBTAINING LICENCE BY MISREPRESENTATION OF FACT ,2013,0,0,0,0,0,0,COMPUTER
TRIPURA,OBTAINING LICENCE BY MISREPRESENTATION OF FACT ,2013,0,0,0,0,0,0,COMPUTER
UTTAR PRADESH,OBTAINING LICENCE BY MISREPRESENTATION OF FACT ,2013,0,3,0,0,0,3,COMPUTER
UTTARAKHAND,OBTAINING LICENCE BY MISREPRESENTATION OF FACT ,2013,0,0,0,0,0,0,COMPUTER
WEST BENGAL,OBTAINING LICENCE BY MISREPRESENTATION OF FACT ,2013,0,0,0,0,0,0,COMPUTER
TOT (STATES),OBTAINING LICENCE BY MISREPRESENTATION OF FACT ,2013,0,10,4,0,0,14,COMPUTER
A & N ISLANDS,OBTAINING LICENCE BY MISREPRESENTATION OF FACT ,2013,0,0,0,0,0,0,COMPUTER
CHANDIGARH,OBTAINING LICENCE BY MISREPRESENTATION OF FACT ,2013,0,0,0,0,0,0,COMPUTER
D & N HAVELI,OBTAINING LICENCE BY MISREPRESENTATION OF FACT ,2013,0,0,0,0,0,0,COMPUTER
DAMAN & DIU,OBTAINING LICENCE BY MISREPRESENTATION OF FACT ,2013,0,0,0,0,0,0,COMPUTER
DELHI,OBTAINING LICENCE BY MISREPRESENTATION OF FACT ,2013,0,0,0,0,0,0,COMPUTER
LAKSHADWEEP,OBTAINING LICENCE BY MISREPRESENTATION OF FACT ,2013,0,0,0,0,0,0,COMPUTER
PUDUCHERRY,OBTAINING LICENCE BY MISREPRESENTATION OF FACT ,2013,0,0,0,0,0,0,COMPUTER
TOT (UTS),OBTAINING LICENCE BY MISREPRESENTATION OF FACT ,2013,0,0,0,0,0,0,COMPUTER
TOT (ALL INDIA),OBTAINING LICENCE BY MISREPRESENTATION OF FACT ,2013,0,10,4,0,0,14,COMPUTER
ANDHRA PRADESH,PUBLISHING FALSE DIGITAL SIGNATURE CERTIFICATE ,2013,0,0,0,1,0,1,COMPUTER
ARUNACHAL PRADESH,PUBLISHING FALSE DIGITAL SIGNATURE CERTIFICATE ,2013,0,0,0,0,0,0,COMPUTER
ASSAM,PUBLISHING FALSE DIGITAL SIGNATURE CERTIFICATE ,2013,0,0,0,0,0,0,COMPUTER
BIHAR,PUBLISHING FALSE DIGITAL SIGNATURE CERTIFICATE ,2013,0,0,0,0,0,0,COMPUTER
CHHATTISGARH,PUBLISHING FALSE DIGITAL SIGNATURE CERTIFICATE ,2013,0,0,0,0,0,0,COMPUTER
GOA,PUBLISHING FALSE DIGITAL SIGNATURE CERTIFICATE ,2013,0,0,0,0,0,0,COMPUTER
GUJARAT,PUBLISHING FALSE DIGITAL SIGNATURE CERTIFICATE ,2013,0,0,0,0,0,0,COMPUTER
HARYANA,PUBLISHING FALSE DIGITAL SIGNATURE CERTIFICATE ,2013,0,0,0,0,0,0,COMPUTER
HIMACHAL PRADESH,PUBLISHING FALSE DIGITAL SIGNATURE CERTIFICATE ,2013,0,0,0,0,0,0,COMPUTER
JAMMU & KASHMIR,PUBLISHING FALSE DIGITAL SIGNATURE CERTIFICATE ,2013,0,0,0,0,0,0,COMPUTER
JHARKHAND,PUBLISHING FALSE DIGITAL SIGNATURE CERTIFICATE ,2013,0,0,0,0,0,0,COMPUTER
KARNATAKA,PUBLISHING FALSE DIGITAL SIGNATURE CERTIFICATE ,2013,0,0,0,0,0,0,COMPUTER
KERALA,PUBLISHING FALSE DIGITAL SIGNATURE CERTIFICATE ,2013,0,0,0,0,0,0,COMPUTER
MADHYA PRADESH,PUBLISHING FALSE DIGITAL SIGNATURE CERTIFICATE ,2013,0,0,0,0,0,0,COMPUTER
MAHARASHTRA,PUBLISHING FALSE DIGITAL SIGNATURE CERTIFICATE ,2013,0,0,0,0,0,0,COMPUTER
MANIPUR,PUBLISHING FALSE DIGITAL SIGNATURE CERTIFICATE ,2013,0,0,0,0,0,0,COMPUTER
MEGHALAYA,PUBLISHING FALSE DIGITAL SIGNATURE CERTIFICATE ,2013,0,0,0,0,0,0,COMPUTER
MIZORAM,PUBLISHING FALSE DIGITAL SIGNATURE CERTIFICATE ,2013,0,0,0,0,0,0,COMPUTER
NAGALAND,PUBLISHING FALSE DIGITAL SIGNATURE CERTIFICATE ,2013,0,0,0,0,0,0,COMPUTER
ORISSA,PUBLISHING FALSE DIGITAL SIGNATURE CERTIFICATE ,2013,0,0,0,0,0,0,COMPUTER
PUNJAB,PUBLISHING FALSE DIGITAL SIGNATURE CERTIFICATE ,2013,0,0,0,0,0,0,COMPUTER
RAJASTHAN,PUBLISHING FALSE DIGITAL SIGNATURE CERTIFICATE ,2013,0,0,0,0,0,0,COMPUTER
SIKKIM,PUBLISHING FALSE DIGITAL SIGNATURE CERTIFICATE ,2013,0,0,0,0,0,0,COMPUTER
TAMIL NADU,PUBLISHING FALSE DIGITAL SIGNATURE CERTIFICATE ,2013,0,0,0,0,0,0,COMPUTER
TRIPURA,PUBLISHING FALSE DIGITAL SIGNATURE CERTIFICATE ,2013,0,0,0,0,0,0,COMPUTER
UTTAR PRADESH,PUBLISHING FALSE DIGITAL SIGNATURE CERTIFICATE ,2013,0,4,3,0,0,7,COMPUTER
UTTARAKHAND,PUBLISHING FALSE DIGITAL SIGNATURE CERTIFICATE ,2013,0,0,0,0,0,0,COMPUTER
WEST BENGAL,PUBLISHING FALSE DIGITAL SIGNATURE CERTIFICATE ,2013,0,0,0,0,0,0,COMPUTER
TOT (STATES),PUBLISHING FALSE DIGITAL SIGNATURE CERTIFICATE ,2013,0,4,3,1,0,8,COMPUTER
A & N ISLANDS,PUBLISHING FALSE DIGITAL SIGNATURE CERTIFICATE ,2013,0,0,0,0,0,0,COMPUTER
CHANDIGARH,PUBLISHING FALSE DIGITAL SIGNATURE CERTIFICATE ,2013,0,0,0,0,0,0,COMPUTER
D & N HAVELI,PUBLISHING FALSE DIGITAL SIGNATURE CERTIFICATE ,2013,0,0,0,0,0,0,COMPUTER
DAMAN & DIU,PUBLISHING FALSE DIGITAL SIGNATURE CERTIFICATE ,2013,0,0,0,0,0,0,COMPUTER
DELHI,PUBLISHING FALSE DIGITAL SIGNATURE CERTIFICATE ,2013,0,0,0,0,0,0,COMPUTER
LAKSHADWEEP,PUBLISHING FALSE DIGITAL SIGNATURE CERTIFICATE ,2013,0,0,0,0,0,0,COMPUTER
PUDUCHERRY,PUBLISHING FALSE DIGITAL SIGNATURE CERTIFICATE ,2013,0,0,0,0,0,0,COMPUTER
TOT (UTS),PUBLISHING FALSE DIGITAL SIGNATURE CERTIFICATE ,2013,0,0,0,0,0,0,COMPUTER
TOT (ALL INDIA),PUBLISHING FALSE DIGITAL SIGNATURE CERTIFICATE ,2013,0,4,3,1,0,8,COMPUTER
ANDHRA PRADESH,FRAUD DIGITAL SIGNATURE CERTIFICATE ,2013,0,1,0,3,0,4,COMPUTER
ARUNACHAL PRADESH,FRAUD DIGITAL SIGNATURE CERTIFICATE ,2013,0,0,0,0,0,0,COMPUTER
ASSAM,FRAUD DIGITAL SIGNATURE CERTIFICATE ,2013,0,0,0,0,0,0,COMPUTER
BIHAR,FRAUD DIGITAL SIGNATURE CERTIFICATE ,2013,0,0,0,0,0,0,COMPUTER
CHHATTISGARH,FRAUD DIGITAL SIGNATURE CERTIFICATE ,2013,0,0,0,0,0,0,COMPUTER
GOA,FRAUD DIGITAL SIGNATURE CERTIFICATE ,2013,0,0,0,0,0,0,COMPUTER
GUJARAT,FRAUD DIGITAL SIGNATURE CERTIFICATE ,2013,0,0,0,0,0,0,COMPUTER
HARYANA,FRAUD DIGITAL SIGNATURE CERTIFICATE ,2013,0,0,0,0,0,0,COMPUTER
HIMACHAL PRADESH,FRAUD DIGITAL SIGNATURE CERTIFICATE ,2013,0,0,0,0,0,0,COMPUTER
JAMMU & KASHMIR,FRAUD DIGITAL SIGNATURE CERTIFICATE ,2013,0,0,0,0,0,0,COMPUTER
JHARKHAND,FRAUD DIGITAL SIGNATURE CERTIFICATE ,2013,0,2,2,0,0,4,COMPUTER
KARNATAKA,FRAUD DIGITAL SIGNATURE CERTIFICATE ,2013,0,0,0,0,0,0,COMPUTER
KERALA,FRAUD DIGITAL SIGNATURE CERTIFICATE ,2013,0,0,0,1,0,1,COMPUTER
MADHYA PRADESH,FRAUD DIGITAL SIGNATURE CERTIFICATE ,2013,0,0,0,0,0,0,COMPUTER
MAHARASHTRA,FRAUD DIGITAL SIGNATURE CERTIFICATE ,2013,0,2,2,1,0,5,COMPUTER
MANIPUR,FRAUD DIGITAL SIGNATURE CERTIFICATE ,2013,0,0,0,0,0,0,COMPUTER
MEGHALAYA,FRAUD DIGITAL SIGNATURE CERTIFICATE ,2013,0,0,0,0,0,0,COMPUTER
MIZORAM,FRAUD DIGITAL SIGNATURE CERTIFICATE ,2013,0,0,0,0,0,0,COMPUTER
NAGALAND,FRAUD DIGITAL SIGNATURE CERTIFICATE ,2013,0,0,0,0,0,0,COMPUTER
ORISSA,FRAUD DIGITAL SIGNATURE CERTIFICATE ,2013,0,12,3,0,0,15,COMPUTER
PUNJAB,FRAUD DIGITAL SIGNATURE CERTIFICATE ,2013,0,1,3,0,0,4,COMPUTER
RAJASTHAN,FRAUD DIGITAL SIGNATURE CERTIFICATE ,2013,0,1,1,0,0,2,COMPUTER
SIKKIM,FRAUD DIGITAL SIGNATURE CERTIFICATE ,2013,0,0,0,0,0,0,COMPUTER
TAMIL NADU,FRAUD DIGITAL SIGNATURE CERTIFICATE ,2013,0,0,0,0,0,0,COMPUTER
TRIPURA,FRAUD DIGITAL SIGNATURE CERTIFICATE ,2013,0,0,0,0,0,0,COMPUTER
UTTAR PRADESH,FRAUD DIGITAL SIGNATURE CERTIFICATE ,2013,0,8,6,0,0,14,COMPUTER
UTTARAKHAND,FRAUD DIGITAL SIGNATURE CERTIFICATE ,2013,0,0,0,0,0,0,COMPUTER
WEST BENGAL,FRAUD DIGITAL SIGNATURE CERTIFICATE ,2013,0,0,0,0,0,0,COMPUTER
TOT (STATES),FRAUD DIGITAL SIGNATURE CERTIFICATE ,2013,0,27,17,5,0,49,COMPUTER
A & N ISLANDS,FRAUD DIGITAL SIGNATURE CERTIFICATE ,2013,0,0,0,0,0,0,COMPUTER
CHANDIGARH,FRAUD DIGITAL SIGNATURE CERTIFICATE ,2013,0,0,0,0,0,0,COMPUTER
D & N HAVELI,FRAUD DIGITAL SIGNATURE CERTIFICATE ,2013,0,0,0,0,0,0,COMPUTER
DAMAN & DIU,FRAUD DIGITAL SIGNATURE CERTIFICATE ,2013,0,0,0,0,0,0,COMPUTER
DELHI,FRAUD DIGITAL SIGNATURE CERTIFICATE ,2013,0,0,2,0,0,2,COMPUTER
LAKSHADWEEP,FRAUD DIGITAL SIGNATURE CERTIFICATE ,2013,0,0,0,0,0,0,COMPUTER
PUDUCHERRY,FRAUD DIGITAL SIGNATURE CERTIFICATE ,2013,0,0,0,0,0,0,COMPUTER
TOT (UTS),FRAUD DIGITAL SIGNATURE CERTIFICATE ,2013,0,0,2,0,0,2,COMPUTER
TOT (ALL INDIA),FRAUD DIGITAL SIGNATURE CERTIFICATE ,2013,0,27,19,5,0,51,COMPUTER
ANDHRA PRADESH,BREACH OF CONFIDENTIALITY ,2013,0,4,1,1,0,6,COMPUTER
ARUNACHAL PRADESH,BREACH OF CONFIDENTIALITY ,2013,0,0,0,0,0,0,COMPUTER
ASSAM,BREACH OF CONFIDENTIALITY ,2013,0,0,0,0,0,0,COMPUTER
BIHAR,BREACH OF CONFIDENTIALITY ,2013,0,0,0,0,0,0,COMPUTER
CHHATTISGARH,BREACH OF CONFIDENTIALITY ,2013,0,0,0,0,0,0,COMPUTER
GOA,BREACH OF CONFIDENTIALITY ,2013,0,0,0,0,0,0,COMPUTER
GUJARAT,BREACH OF CONFIDENTIALITY ,2013,0,0,0,0,0,0,COMPUTER
HARYANA,BREACH OF CONFIDENTIALITY ,2013,0,0,0,0,0,0,COMPUTER
HIMACHAL PRADESH,BREACH OF CONFIDENTIALITY ,2013,0,0,0,0,0,0,COMPUTER
JAMMU & KASHMIR,BREACH OF CONFIDENTIALITY ,2013,0,0,0,0,0,0,COMPUTER
JHARKHAND,BREACH OF CONFIDENTIALITY ,2013,0,0,0,0,0,0,COMPUTER
KARNATAKA,BREACH OF CONFIDENTIALITY ,2013,0,0,2,0,0,2,COMPUTER
KERALA,BREACH OF CONFIDENTIALITY ,2013,0,4,2,1,0,7,COMPUTER
MADHYA PRADESH,BREACH OF CONFIDENTIALITY ,2013,0,0,0,0,0,0,COMPUTER
MAHARASHTRA,BREACH OF CONFIDENTIALITY ,2013,0,1,1,1,0,3,COMPUTER
MANIPUR,BREACH OF CONFIDENTIALITY ,2013,0,0,0,0,0,0,COMPUTER
MEGHALAYA,BREACH OF CONFIDENTIALITY ,2013,0,0,0,0,0,0,COMPUTER
MIZORAM,BREACH OF CONFIDENTIALITY ,2013,0,0,0,0,0,0,COMPUTER
NAGALAND,BREACH OF CONFIDENTIALITY ,2013,0,0,0,0,0,0,COMPUTER
ORISSA,BREACH OF CONFIDENTIALITY ,2013,0,0,0,0,0,0,COMPUTER
PUNJAB,BREACH OF CONFIDENTIALITY ,2013,0,0,0,0,0,0,COMPUTER
RAJASTHAN,BREACH OF CONFIDENTIALITY ,2013,0,0,0,0,0,0,COMPUTER
SIKKIM,BREACH OF CONFIDENTIALITY ,2013,0,0,0,0,0,0,COMPUTER
TAMIL NADU,BREACH OF CONFIDENTIALITY ,2013,0,0,0,0,0,0,COMPUTER
TRIPURA,BREACH OF CONFIDENTIALITY ,2013,0,0,0,0,0,0,COMPUTER
UTTAR PRADESH,BREACH OF CONFIDENTIALITY ,2013,0,9,0,0,0,9,COMPUTER
UTTARAKHAND,BREACH OF CONFIDENTIALITY ,2013,0,0,0,0,0,0,COMPUTER
WEST BENGAL,BREACH OF CONFIDENTIALITY ,2013,0,0,2,0,0,2,COMPUTER
TOT (STATES),BREACH OF CONFIDENTIALITY ,2013,0,18,8,3,0,29,COMPUTER
A & N ISLANDS,BREACH OF CONFIDENTIALITY ,2013,0,0,0,0,0,0,COMPUTER
CHANDIGARH,BREACH OF CONFIDENTIALITY ,2013,0,0,0,0,0,0,COMPUTER
D & N HAVELI,BREACH OF CONFIDENTIALITY ,2013,0,0,0,0,0,0,COMPUTER
DAMAN & DIU,BREACH OF CONFIDENTIALITY ,2013,0,0,0,0,0,0,COMPUTER
DELHI,BREACH OF CONFIDENTIALITY ,2013,0,1,0,0,0,1,COMPUTER
LAKSHADWEEP,BREACH OF CONFIDENTIALITY ,2013,0,0,0,0,0,0,COMPUTER
PUDUCHERRY,BREACH OF CONFIDENTIALITY ,2013,0,0,0,0,0,0,COMPUTER
TOT (UTS),BREACH OF CONFIDENTIALITY ,2013,0,1,0,0,0,1,COMPUTER
TOT (ALL INDIA),BREACH OF CONFIDENTIALITY ,2013,0,19,8,3,0,30,COMPUTER
ANDHRA PRADESH,OTHER ,2013,0,0,0,0,0,0,COMPUTER
ARUNACHAL PRADESH,OTHER ,2013,0,0,0,0,0,0,COMPUTER
ASSAM,OTHER ,2013,0,0,0,0,0,0,COMPUTER
BIHAR,OTHER ,2013,0,0,0,0,0,0,COMPUTER
CHHATTISGARH,OTHER ,2013,0,0,0,0,0,0,COMPUTER
GOA,OTHER ,2013,0,0,0,0,0,0,COMPUTER
GUJARAT,OTHER ,2013,0,0,0,0,0,0,COMPUTER
HARYANA,OTHER ,2013,0,0,0,0,0,0,COMPUTER
HIMACHAL PRADESH,OTHER ,2013,0,0,0,0,0,0,COMPUTER
JAMMU & KASHMIR,OTHER ,2013,0,6,4,0,0,10,COMPUTER
JHARKHAND,OTHER ,2013,0,0,0,0,0,0,COMPUTER
KARNATAKA,OTHER ,2013,0,0,0,0,0,0,COMPUTER
KERALA,OTHER ,2013,0,0,0,0,0,0,COMPUTER
MADHYA PRADESH,OTHER ,2013,0,0,0,0,0,0,COMPUTER
MAHARASHTRA,OTHER ,2013,9,84,49,8,1,151,COMPUTER
MANIPUR,OTHER ,2013,0,0,0,0,0,0,COMPUTER
MEGHALAYA,OTHER ,2013,0,0,0,0,0,0,COMPUTER
MIZORAM,OTHER ,2013,0,0,0,0,0,0,COMPUTER
NAGALAND,OTHER ,2013,0,0,0,0,0,0,COMPUTER
ORISSA,OTHER ,2013,0,0,0,0,0,0,COMPUTER
PUNJAB,OTHER ,2013,0,0,0,0,0,0,COMPUTER
RAJASTHAN,OTHER ,2013,0,0,0,0,0,0,COMPUTER
SIKKIM,OTHER ,2013,0,0,0,0,0,0,COMPUTER
TAMIL NADU,OTHER ,2013,0,0,0,0,0,0,COMPUTER
TRIPURA,OTHER ,2013,0,0,0,0,0,0,COMPUTER
UTTAR PRADESH,OTHER ,2013,0,0,0,0,0,0,COMPUTER
UTTARAKHAND,OTHER ,2013,0,0,0,0,0,0,COMPUTER
WEST BENGAL,OTHER ,2013,0,0,0,0,0,0,COMPUTER
TOT (STATES),OTHER ,2013,9,90,53,8,1,161,COMPUTER
A & N ISLANDS,OTHER ,2013,0,0,0,0,0,0,COMPUTER
CHANDIGARH,OTHER ,2013,0,0,0,0,0,0,COMPUTER
D & N HAVELI,OTHER ,2013,0,0,0,0,0,0,COMPUTER
DAMAN & DIU,OTHER ,2013,0,0,0,0,0,0,COMPUTER
DELHI,OTHER ,2013,0,0,0,0,0,0,COMPUTER
LAKSHADWEEP,OTHER ,2013,0,0,0,0,0,0,COMPUTER
PUDUCHERRY,OTHER ,2013,0,0,0,0,0,0,COMPUTER
TOT (UTS),OTHER ,2013,0,0,0,0,0,0,COMPUTER
TOT (ALL INDIA),OTHER ,2013,9,90,53,8,1,161,COMPUTER
ANDHRA PRADESH,TOTAL ,2013,9,180,94,13,0,296,COMPUTER
ARUNACHAL PRADESH,TOTAL ,2013,0,0,5,0,0,5,COMPUTER
ASSAM,TOTAL ,2013,0,2,0,0,0,2,COMPUTER
BIHAR,TOTAL ,2013,0,16,6,0,0,22,COMPUTER
CHHATTISGARH,TOTAL ,2013,0,19,16,0,0,35,COMPUTER
GOA,TOTAL ,2013,0,4,4,2,0,10,COMPUTER
GUJARAT,TOTAL ,2013,0,28,14,8,1,51,COMPUTER
HARYANA,TOTAL ,2013,1,29,24,3,1,58,COMPUTER
HIMACHAL PRADESH,TOTAL ,2013,0,9,4,0,0,13,COMPUTER
JAMMU & KASHMIR,TOTAL ,2013,0,9,6,1,0,16,COMPUTER
JHARKHAND,TOTAL ,2013,0,5,2,0,0,7,COMPUTER
KARNATAKA,TOTAL ,2013,0,45,45,3,1,94,COMPUTER
KERALA,TOTAL ,2013,9,73,52,17,0,151,COMPUTER
MADHYA PRADESH,TOTAL ,2013,2,104,44,13,2,165,COMPUTER
MAHARASHTRA,TOTAL ,2013,17,214,161,31,3,426,COMPUTER
MANIPUR,TOTAL ,2013,0,0,0,0,0,0,COMPUTER
MEGHALAYA,TOTAL ,2013,0,0,0,0,0,0,COMPUTER
MIZORAM,TOTAL ,2013,0,0,0,0,0,0,COMPUTER
NAGALAND,TOTAL ,2013,0,0,0,0,0,0,COMPUTER
ORISSA,TOTAL ,2013,0,20,21,0,0,41,COMPUTER
PUNJAB,TOTAL ,2013,4,57,58,3,1,123,COMPUTER
RAJASTHAN,TOTAL ,2013,2,80,42,11,0,135,COMPUTER
SIKKIM,TOTAL ,2013,0,0,0,0,0,0,COMPUTER
TAMIL NADU,TOTAL ,2013,0,18,12,12,1,43,COMPUTER
TRIPURA,TOTAL ,2013,1,10,2,0,0,13,COMPUTER
UTTAR PRADESH,TOTAL ,2013,0,213,65,5,0,283,COMPUTER
UTTARAKHAND,TOTAL ,2013,0,2,1,0,0,3,COMPUTER
WEST BENGAL,TOTAL ,2013,0,26,27,5,0,58,COMPUTER
TOT (STATES),TOTAL ,2013,45,1163,705,127,10,2050,COMPUTER
A & N ISLANDS,TOTAL ,2013,0,3,0,0,0,3,COMPUTER
CHANDIGARH,TOTAL ,2013,0,7,0,0,0,7,COMPUTER
D & N HAVELI,TOTAL ,2013,0,0,0,0,0,0,COMPUTER
DAMAN & DIU,TOTAL ,2013,0,0,2,0,0,2,COMPUTER
DELHI,TOTAL ,2013,0,17,14,3,0,34,COMPUTER
LAKSHADWEEP,TOTAL ,2013,0,0,0,0,0,0,COMPUTER
PUDUCHERRY,TOTAL ,2013,0,0,1,1,0,2,COMPUTER
TOT (UTS),TOTAL ,2013,0,27,17,4,0,48,COMPUTER
TOT (ALL INDIA),TOTAL ,2013,45,1190,722,131,10,2098,COMPUTER
ANDHRA PRADESH,OFFENCES BY OR AGAINST PUBLIC SERVANT ,2013,0,0,0,0,0,0,COMPUTER
ARUNACHAL PRADESH,OFFENCES BY OR AGAINST PUBLIC SERVANT ,2013,0,0,0,0,0,0,COMPUTER
ASSAM,OFFENCES BY OR AGAINST PUBLIC SERVANT ,2013,0,0,0,0,0,0,COMPUTER
BIHAR,OFFENCES BY OR AGAINST PUBLIC SERVANT ,2013,0,0,0,0,0,0,COMPUTER
CHHATTISGARH,OFFENCES BY OR AGAINST PUBLIC SERVANT ,2013,0,0,0,0,0,0,COMPUTER
GOA,OFFENCES BY OR AGAINST PUBLIC SERVANT ,2013,0,0,0,0,0,0,COMPUTER
GUJARAT,OFFENCES BY OR AGAINST PUBLIC SERVANT ,2013,0,0,0,0,0,0,COMPUTER
HARYANA,OFFENCES BY OR AGAINST PUBLIC SERVANT ,2013,0,0,0,0,0,0,COMPUTER
HIMACHAL PRADESH,OFFENCES BY OR AGAINST PUBLIC SERVANT ,2013,0,0,0,0,0,0,COMPUTER
JAMMU & KASHMIR,OFFENCES BY OR AGAINST PUBLIC SERVANT ,2013,0,0,0,0,0,0,COMPUTER
JHARKHAND,OFFENCES BY OR AGAINST PUBLIC SERVANT ,2013,0,2,0,0,0,2,COMPUTER
KARNATAKA,OFFENCES BY OR AGAINST PUBLIC SERVANT ,2013,0,0,0,0,0,0,COMPUTER
KERALA,OFFENCES BY OR AGAINST PUBLIC SERVANT ,2013,0,0,0,0,0,0,COMPUTER
MADHYA PRADESH,OFFENCES BY OR AGAINST PUBLIC SERVANT ,2013,0,0,0,0,0,0,COMPUTER
MAHARASHTRA,OFFENCES BY OR AGAINST PUBLIC SERVANT ,2013,0,0,0,0,0,0,COMPUTER
MANIPUR,OFFENCES BY OR AGAINST PUBLIC SERVANT ,2013,0,0,0,0,0,0,COMPUTER
MEGHALAYA,OFFENCES BY OR AGAINST PUBLIC SERVANT ,2013,0,0,0,0,0,0,COMPUTER
MIZORAM,OFFENCES BY OR AGAINST PUBLIC SERVANT ,2013,0,0,0,0,0,0,COMPUTER
NAGALAND,OFFENCES BY OR AGAINST PUBLIC SERVANT ,2013,0,0,0,0,0,0,COMPUTER
ORISSA,OFFENCES BY OR AGAINST PUBLIC SERVANT ,2013,0,0,0,0,0,0,COMPUTER
PUNJAB,OFFENCES BY OR AGAINST PUBLIC SERVANT ,2013,0,0,0,0,0,0,COMPUTER
RAJASTHAN,OFFENCES BY OR AGAINST PUBLIC SERVANT ,2013,0,0,0,0,0,0,COMPUTER
SIKKIM,OFFENCES BY OR AGAINST PUBLIC SERVANT ,2013,0,0,0,0,0,0,COMPUTER
TAMIL NADU,OFFENCES BY OR AGAINST PUBLIC SERVANT ,2013,0,0,0,0,0,0,COMPUTER
TRIPURA,OFFENCES BY OR AGAINST PUBLIC SERVANT ,2013,0,0,0,0,0,0,COMPUTER
UTTAR PRADESH,OFFENCES BY OR AGAINST PUBLIC SERVANT ,2013,0,0,0,0,0,0,COMPUTER
UTTARAKHAND,OFFENCES BY OR AGAINST PUBLIC SERVANT ,2013,0,0,0,0,0,0,COMPUTER
WEST BENGAL,OFFENCES BY OR AGAINST PUBLIC SERVANT ,2013,0,0,0,0,0,0,COMPUTER
TOT (STATES),OFFENCES BY OR AGAINST PUBLIC SERVANT ,2013,0,2,0,0,0,2,COMPUTER
A & N ISLANDS,OFFENCES BY OR AGAINST PUBLIC SERVANT ,2013,0,0,0,0,0,0,COMPUTER
CHANDIGARH,OFFENCES BY OR AGAINST PUBLIC SERVANT ,2013,0,0,0,0,0,0,COMPUTER
D & N HAVELI,OFFENCES BY OR AGAINST PUBLIC SERVANT ,2013,0,0,0,0,0,0,COMPUTER
DAMAN & DIU,OFFENCES BY OR AGAINST PUBLIC SERVANT ,2013,0,0,0,0,0,0,COMPUTER
DELHI,OFFENCES BY OR AGAINST PUBLIC SERVANT ,2013,0,0,0,0,0,0,COMPUTER
LAKSHADWEEP,OFFENCES BY OR AGAINST PUBLIC SERVANT ,2013,0,0,0,0,0,0,COMPUTER
PUDUCHERRY,OFFENCES BY OR AGAINST PUBLIC SERVANT ,2013,0,0,0,0,0,0,COMPUTER
TOT (UTS),OFFENCES BY OR AGAINST PUBLIC SERVANT ,2013,0,0,0,0,0,0,COMPUTER
TOT (ALL INDIA),OFFENCES BY OR AGAINST PUBLIC SERVANT ,2013,0,2,0,0,0,2,COMPUTER
ANDHRA PRADESH,FALSE ELECTRONIC EVIDENCE ,2013,0,0,0,0,0,0,COMPUTER
ARUNACHAL PRADESH,FALSE ELECTRONIC EVIDENCE ,2013,0,0,0,0,0,0,COMPUTER
ASSAM,FALSE ELECTRONIC EVIDENCE ,2013,0,0,0,0,0,0,COMPUTER
BIHAR,FALSE ELECTRONIC EVIDENCE ,2013,0,0,0,0,0,0,COMPUTER
CHHATTISGARH,FALSE ELECTRONIC EVIDENCE ,2013,0,0,0,0,0,0,COMPUTER
GOA,FALSE ELECTRONIC EVIDENCE ,2013,0,0,0,0,0,0,COMPUTER
GUJARAT,FALSE ELECTRONIC EVIDENCE ,2013,0,0,0,0,0,0,COMPUTER
HARYANA,FALSE ELECTRONIC EVIDENCE ,2013,0,0,0,0,0,0,COMPUTER
HIMACHAL PRADESH,FALSE ELECTRONIC EVIDENCE ,2013,0,0,0,0,0,0,COMPUTER
JAMMU & KASHMIR,FALSE ELECTRONIC EVIDENCE ,2013,0,0,0,0,0,0,COMPUTER
JHARKHAND,FALSE ELECTRONIC EVIDENCE ,2013,0,0,0,0,0,0,COMPUTER
KARNATAKA,FALSE ELECTRONIC EVIDENCE ,2013,0,0,0,0,0,0,COMPUTER
KERALA,FALSE ELECTRONIC EVIDENCE ,2013,0,6,0,1,0,7,COMPUTER
MADHYA PRADESH,FALSE ELECTRONIC EVIDENCE ,2013,0,0,0,0,0,0,COMPUTER
MAHARASHTRA,FALSE ELECTRONIC EVIDENCE ,2013,0,0,0,0,0,0,COMPUTER
MANIPUR,FALSE ELECTRONIC EVIDENCE ,2013,0,0,0,0,0,0,COMPUTER
MEGHALAYA,FALSE ELECTRONIC EVIDENCE ,2013,0,0,0,0,0,0,COMPUTER
MIZORAM,FALSE ELECTRONIC EVIDENCE ,2013,0,0,0,0,0,0,COMPUTER
NAGALAND,FALSE ELECTRONIC EVIDENCE ,2013,0,0,0,0,0,0,COMPUTER
ORISSA,FALSE ELECTRONIC EVIDENCE ,2013,0,0,0,0,0,0,COMPUTER
PUNJAB,FALSE ELECTRONIC EVIDENCE ,2013,0,0,0,0,0,0,COMPUTER
RAJASTHAN,FALSE ELECTRONIC EVIDENCE ,2013,0,0,0,0,0,0,COMPUTER
SIKKIM,FALSE ELECTRONIC EVIDENCE ,2013,0,0,0,0,0,0,COMPUTER
TAMIL NADU,FALSE ELECTRONIC EVIDENCE ,2013,0,0,0,0,0,0,COMPUTER
TRIPURA,FALSE ELECTRONIC EVIDENCE ,2013,0,0,0,0,0,0,COMPUTER
UTTAR PRADESH,FALSE ELECTRONIC EVIDENCE ,2013,0,0,0,0,0,0,COMPUTER
UTTARAKHAND,FALSE ELECTRONIC EVIDENCE ,2013,0,0,0,0,0,0,COMPUTER
WEST BENGAL,FALSE ELECTRONIC EVIDENCE ,2013,0,0,0,0,0,0,COMPUTER
TOT (STATES),FALSE ELECTRONIC EVIDENCE ,2013,0,6,0,1,0,7,COMPUTER
A & N ISLANDS,FALSE ELECTRONIC EVIDENCE ,2013,0,0,0,0,0,0,COMPUTER
CHANDIGARH,FALSE ELECTRONIC EVIDENCE ,2013,0,0,0,0,0,0,COMPUTER
D & N HAVELI,FALSE ELECTRONIC EVIDENCE ,2013,0,0,0,0,0,0,COMPUTER
DAMAN & DIU,FALSE ELECTRONIC EVIDENCE ,2013,0,0,0,0,0,0,COMPUTER
DELHI,FALSE ELECTRONIC EVIDENCE ,2013,0,0,0,0,0,0,COMPUTER
LAKSHADWEEP,FALSE ELECTRONIC EVIDENCE ,2013,0,0,0,0,0,0,COMPUTER
PUDUCHERRY,FALSE ELECTRONIC EVIDENCE ,2013,0,0,0,0,0,0,COMPUTER
TOT (UTS),FALSE ELECTRONIC EVIDENCE ,2013,0,0,0,0,0,0,COMPUTER
TOT (ALL INDIA),FALSE ELECTRONIC EVIDENCE ,2013,0,6,0,1,0,7,COMPUTER
ANDHRA PRADESH,DESTRUCTION OF ELECTRONIC EVIDENCE ,2013,0,0,0,0,0,0,COMPUTER
ARUNACHAL PRADESH,DESTRUCTION OF ELECTRONIC EVIDENCE ,2013,0,0,0,0,0,0,COMPUTER
ASSAM,DESTRUCTION OF ELECTRONIC EVIDENCE ,2013,0,0,0,0,0,0,COMPUTER
BIHAR,DESTRUCTION OF ELECTRONIC EVIDENCE ,2013,0,0,0,0,0,0,COMPUTER
CHHATTISGARH,DESTRUCTION OF ELECTRONIC EVIDENCE ,2013,0,0,0,0,0,0,COMPUTER
GOA,DESTRUCTION OF ELECTRONIC EVIDENCE ,2013,0,0,0,0,0,0,COMPUTER
GUJARAT,DESTRUCTION OF ELECTRONIC EVIDENCE ,2013,0,0,0,0,0,0,COMPUTER
HARYANA,DESTRUCTION OF ELECTRONIC EVIDENCE ,2013,0,3,0,0,0,3,COMPUTER
HIMACHAL PRADESH,DESTRUCTION OF ELECTRONIC EVIDENCE ,2013,0,0,0,0,0,0,COMPUTER
JAMMU & KASHMIR,DESTRUCTION OF ELECTRONIC EVIDENCE ,2013,0,0,0,0,0,0,COMPUTER
JHARKHAND,DESTRUCTION OF ELECTRONIC EVIDENCE ,2013,0,0,0,0,0,0,COMPUTER
KARNATAKA,DESTRUCTION OF ELECTRONIC EVIDENCE ,2013,0,0,0,0,0,0,COMPUTER
KERALA,DESTRUCTION OF ELECTRONIC EVIDENCE ,2013,0,0,0,0,0,0,COMPUTER
MADHYA PRADESH,DESTRUCTION OF ELECTRONIC EVIDENCE ,2013,0,0,0,0,0,0,COMPUTER
MAHARASHTRA,DESTRUCTION OF ELECTRONIC EVIDENCE ,2013,0,0,0,0,0,0,COMPUTER
MANIPUR,DESTRUCTION OF ELECTRONIC EVIDENCE ,2013,0,0,0,0,0,0,COMPUTER
MEGHALAYA,DESTRUCTION OF ELECTRONIC EVIDENCE ,2013,0,0,0,0,0,0,COMPUTER
MIZORAM,DESTRUCTION OF ELECTRONIC EVIDENCE ,2013,0,0,0,0,0,0,COMPUTER
NAGALAND,DESTRUCTION OF ELECTRONIC EVIDENCE ,2013,0,0,0,0,0,0,COMPUTER
ORISSA,DESTRUCTION OF ELECTRONIC EVIDENCE ,2013,0,0,1,0,0,1,COMPUTER
PUNJAB,DESTRUCTION OF ELECTRONIC EVIDENCE ,2013,0,0,0,0,0,0,COMPUTER
RAJASTHAN,DESTRUCTION OF ELECTRONIC EVIDENCE ,2013,0,0,0,0,0,0,COMPUTER
SIKKIM,DESTRUCTION OF ELECTRONIC EVIDENCE ,2013,0,0,0,0,0,0,COMPUTER
TAMIL NADU,DESTRUCTION OF ELECTRONIC EVIDENCE ,2013,0,0,0,0,0,0,COMPUTER
TRIPURA,DESTRUCTION OF ELECTRONIC EVIDENCE ,2013,0,0,0,0,0,0,COMPUTER
UTTAR PRADESH,DESTRUCTION OF ELECTRONIC EVIDENCE ,2013,0,0,0,0,0,0,COMPUTER
UTTARAKHAND,DESTRUCTION OF ELECTRONIC EVIDENCE ,2013,0,0,0,0,0,0,COMPUTER
WEST BENGAL,DESTRUCTION OF ELECTRONIC EVIDENCE ,2013,0,0,0,0,0,0,COMPUTER
TOT (STATES),DESTRUCTION OF ELECTRONIC EVIDENCE ,2013,0,3,1,0,0,4,COMPUTER
A & N ISLANDS,DESTRUCTION OF ELECTRONIC EVIDENCE ,2013,0,0,0,0,0,0,COMPUTER
CHANDIGARH,DESTRUCTION OF ELECTRONIC EVIDENCE ,2013,0,0,0,0,0,0,COMPUTER
D & N HAVELI,DESTRUCTION OF ELECTRONIC EVIDENCE ,2013,0,0,0,0,0,0,COMPUTER
DAMAN & DIU,DESTRUCTION OF ELECTRONIC EVIDENCE ,2013,0,0,0,0,0,0,COMPUTER
DELHI,DESTRUCTION OF ELECTRONIC EVIDENCE ,2013,0,0,0,0,0,0,COMPUTER
LAKSHADWEEP,DESTRUCTION OF ELECTRONIC EVIDENCE ,2013,0,0,0,0,0,0,COMPUTER
PUDUCHERRY,DESTRUCTION OF ELECTRONIC EVIDENCE ,2013,0,0,0,0,0,0,COMPUTER
TOT (UTS),DESTRUCTION OF ELECTRONIC EVIDENCE ,2013,0,0,0,0,0,0,COMPUTER
TOT (ALL INDIA),DESTRUCTION OF ELECTRONIC EVIDENCE ,2013,0,3,1,0,0,4,COMPUTER
ANDHRA PRADESH,FORGERY ,2013,0,2,0,0,0,2,COMPUTER
ARUNACHAL PRADESH,FORGERY ,2013,0,0,0,0,0,0,COMPUTER
ASSAM,FORGERY ,2013,0,0,0,0,0,0,COMPUTER
BIHAR,FORGERY ,2013,0,2,70,1,0,73,COMPUTER
CHHATTISGARH,FORGERY ,2013,0,2,4,1,0,7,COMPUTER
GOA,FORGERY ,2013,0,0,1,0,0,1,COMPUTER
GUJARAT,FORGERY ,2013,0,0,1,0,0,1,COMPUTER
HARYANA,FORGERY ,2013,0,15,35,17,3,70,COMPUTER
HIMACHAL PRADESH,FORGERY ,2013,0,0,0,0,0,0,COMPUTER
JAMMU & KASHMIR,FORGERY ,2013,0,0,0,0,0,0,COMPUTER
JHARKHAND,FORGERY ,2013,0,1,0,0,0,1,COMPUTER
KARNATAKA,FORGERY ,2013,0,1,0,0,0,1,COMPUTER
KERALA,FORGERY ,2013,0,1,2,5,0,8,COMPUTER
MADHYA PRADESH,FORGERY ,2013,0,2,2,1,0,5,COMPUTER
MAHARASHTRA,FORGERY ,2013,0,59,82,14,1,156,COMPUTER
MANIPUR,FORGERY ,2013,0,0,0,0,0,0,COMPUTER
MEGHALAYA,FORGERY ,2013,0,0,0,0,0,0,COMPUTER
MIZORAM,FORGERY ,2013,0,0,0,0,0,0,COMPUTER
NAGALAND,FORGERY ,2013,0,0,0,0,0,0,COMPUTER
ORISSA,FORGERY ,2013,0,3,15,2,0,20,COMPUTER
PUNJAB,FORGERY ,2013,0,0,2,0,0,2,COMPUTER
RAJASTHAN,FORGERY ,2013,0,4,2,0,0,6,COMPUTER
SIKKIM,FORGERY ,2013,0,0,0,0,0,0,COMPUTER
TAMIL NADU,FORGERY ,2013,0,16,9,0,0,25,COMPUTER
TRIPURA,FORGERY ,2013,0,0,0,0,0,0,COMPUTER
UTTAR PRADESH,FORGERY ,2013,0,143,68,8,0,219,COMPUTER
UTTARAKHAND,FORGERY ,2013,0,0,0,0,0,0,COMPUTER
WEST BENGAL,FORGERY ,2013,0,10,7,3,0,20,COMPUTER
TOT (STATES),FORGERY ,2013,0,261,300,52,4,617,COMPUTER
A & N ISLANDS,FORGERY ,2013,0,0,0,0,0,0,COMPUTER
CHANDIGARH,FORGERY ,2013,0,2,0,0,0,2,COMPUTER
D & N HAVELI,FORGERY ,2013,0,0,0,0,0,0,COMPUTER
DAMAN & DIU,FORGERY ,2013,0,0,0,0,0,0,COMPUTER
DELHI,FORGERY ,2013,0,0,5,2,0,7,COMPUTER
LAKSHADWEEP,FORGERY ,2013,0,0,0,0,0,0,COMPUTER
PUDUCHERRY,FORGERY ,2013,0,0,0,0,0,0,COMPUTER
TOT (UTS),FORGERY ,2013,0,2,5,2,0,9,COMPUTER
TOT (ALL INDIA),FORGERY ,2013,0,263,305,54,4,626,COMPUTER
ANDHRA PRADESH,CRIMINAL BREACH OF TRUST ,2013,0,0,1,0,0,1,COMPUTER
ARUNACHAL PRADESH,CRIMINAL BREACH OF TRUST ,2013,0,0,0,0,0,0,COMPUTER
ASSAM,CRIMINAL BREACH OF TRUST ,2013,0,0,0,0,0,0,COMPUTER
BIHAR,CRIMINAL BREACH OF TRUST ,2013,0,5,126,3,0,134,COMPUTER
CHHATTISGARH,CRIMINAL BREACH OF TRUST ,2013,0,1,3,4,0,8,COMPUTER
GOA,CRIMINAL BREACH OF TRUST ,2013,0,0,0,0,0,0,COMPUTER
GUJARAT,CRIMINAL BREACH OF TRUST ,2013,0,5,5,0,0,10,COMPUTER
HARYANA,CRIMINAL BREACH OF TRUST ,2013,0,24,23,11,0,58,COMPUTER
HIMACHAL PRADESH,CRIMINAL BREACH OF TRUST ,2013,0,0,0,0,0,0,COMPUTER
JAMMU & KASHMIR,CRIMINAL BREACH OF TRUST ,2013,0,0,0,0,0,0,COMPUTER
JHARKHAND,CRIMINAL BREACH OF TRUST ,2013,0,10,0,0,0,10,COMPUTER
KARNATAKA,CRIMINAL BREACH OF TRUST ,2013,0,0,1,0,0,1,COMPUTER
KERALA,CRIMINAL BREACH OF TRUST ,2013,0,0,1,2,0,3,COMPUTER
MADHYA PRADESH,CRIMINAL BREACH OF TRUST ,2013,0,7,0,0,0,7,COMPUTER
MAHARASHTRA,CRIMINAL BREACH OF TRUST ,2013,0,4,5,1,0,10,COMPUTER
MANIPUR,CRIMINAL BREACH OF TRUST ,2013,0,0,0,0,0,0,COMPUTER
MEGHALAYA,CRIMINAL BREACH OF TRUST ,2013,0,0,0,0,0,0,COMPUTER
MIZORAM,CRIMINAL BREACH OF TRUST ,2013,0,0,0,0,0,0,COMPUTER
NAGALAND,CRIMINAL BREACH OF TRUST ,2013,0,0,0,0,0,0,COMPUTER
ORISSA,CRIMINAL BREACH OF TRUST ,2013,0,0,0,0,0,0,COMPUTER
PUNJAB,CRIMINAL BREACH OF TRUST ,2013,0,0,2,0,0,2,COMPUTER
RAJASTHAN,CRIMINAL BREACH OF TRUST ,2013,0,2,2,0,0,4,COMPUTER
SIKKIM,CRIMINAL BREACH OF TRUST ,2013,0,0,0,0,0,0,COMPUTER
TAMIL NADU,CRIMINAL BREACH OF TRUST ,2013,0,8,10,2,0,20,COMPUTER
TRIPURA,CRIMINAL BREACH OF TRUST ,2013,0,0,0,0,0,0,COMPUTER
UTTAR PRADESH,CRIMINAL BREACH OF TRUST ,2013,0,61,31,8,0,100,COMPUTER
UTTARAKHAND,CRIMINAL BREACH OF TRUST ,2013,0,1,2,0,0,3,COMPUTER
WEST BENGAL,CRIMINAL BREACH OF TRUST ,2013,0,17,48,35,0,100,COMPUTER
TOT (STATES),CRIMINAL BREACH OF TRUST ,2013,0,145,260,66,0,471,COMPUTER
A & N ISLANDS,CRIMINAL BREACH OF TRUST ,2013,0,0,0,0,0,0,COMPUTER
CHANDIGARH,CRIMINAL BREACH OF TRUST ,2013,0,0,0,0,0,0,COMPUTER
D & N HAVELI,CRIMINAL BREACH OF TRUST ,2013,0,0,0,0,0,0,COMPUTER
DAMAN & DIU,CRIMINAL BREACH OF TRUST ,2013,0,0,0,0,0,0,COMPUTER
DELHI,CRIMINAL BREACH OF TRUST ,2013,0,0,0,0,0,0,COMPUTER
LAKSHADWEEP,CRIMINAL BREACH OF TRUST ,2013,0,0,0,0,0,0,COMPUTER
PUDUCHERRY,CRIMINAL BREACH OF TRUST ,2013,0,0,0,0,0,0,COMPUTER
TOT (UTS),CRIMINAL BREACH OF TRUST ,2013,0,0,0,0,0,0,COMPUTER
TOT (ALL INDIA),CRIMINAL BREACH OF TRUST ,2013,0,145,260,66,0,471,COMPUTER
ANDHRA PRADESH,COUNTERFEITING-PROPERTY ,2013,0,0,4,0,0,4,COMPUTER
ARUNACHAL PRADESH,COUNTERFEITING-PROPERTY ,2013,0,0,0,0,0,0,COMPUTER
ASSAM,COUNTERFEITING-PROPERTY ,2013,0,0,0,0,0,0,COMPUTER
BIHAR,COUNTERFEITING-PROPERTY ,2013,0,0,0,0,0,0,COMPUTER
CHHATTISGARH,COUNTERFEITING-PROPERTY ,2013,0,0,0,0,0,0,COMPUTER
GOA,COUNTERFEITING-PROPERTY ,2013,0,0,0,0,0,0,COMPUTER
GUJARAT,COUNTERFEITING-PROPERTY ,2013,0,1,0,0,0,1,COMPUTER
HARYANA,COUNTERFEITING-PROPERTY ,2013,0,0,0,0,0,0,COMPUTER
HIMACHAL PRADESH,COUNTERFEITING-PROPERTY ,2013,0,0,0,0,0,0,COMPUTER
JAMMU & KASHMIR,COUNTERFEITING-PROPERTY ,2013,0,0,0,0,0,0,COMPUTER
JHARKHAND,COUNTERFEITING-PROPERTY ,2013,0,0,0,0,0,0,COMPUTER
KARNATAKA,COUNTERFEITING-PROPERTY ,2013,0,0,0,0,0,0,COMPUTER
KERALA,COUNTERFEITING-PROPERTY ,2013,0,0,0,0,0,0,COMPUTER
MADHYA PRADESH,COUNTERFEITING-PROPERTY ,2013,0,0,0,0,0,0,COMPUTER
MAHARASHTRA,COUNTERFEITING-PROPERTY ,2013,0,1,6,4,0,11,COMPUTER
MANIPUR,COUNTERFEITING-PROPERTY ,2013,0,0,0,0,0,0,COMPUTER
MEGHALAYA,COUNTERFEITING-PROPERTY ,2013,0,0,0,0,0,0,COMPUTER
MIZORAM,COUNTERFEITING-PROPERTY ,2013,0,0,0,0,0,0,COMPUTER
NAGALAND,COUNTERFEITING-PROPERTY ,2013,0,0,0,0,0,0,COMPUTER
ORISSA,COUNTERFEITING-PROPERTY ,2013,0,0,0,0,0,0,COMPUTER
PUNJAB,COUNTERFEITING-PROPERTY ,2013,0,0,2,1,0,3,COMPUTER
RAJASTHAN,COUNTERFEITING-PROPERTY ,2013,0,6,0,0,0,6,COMPUTER
SIKKIM,COUNTERFEITING-PROPERTY ,2013,0,0,0,0,0,0,COMPUTER
TAMIL NADU,COUNTERFEITING-PROPERTY ,2013,0,0,3,4,2,9,COMPUTER
TRIPURA,COUNTERFEITING-PROPERTY ,2013,0,0,0,0,0,0,COMPUTER
UTTAR PRADESH,COUNTERFEITING-PROPERTY ,2013,0,0,0,0,0,0,COMPUTER
UTTARAKHAND,COUNTERFEITING-PROPERTY ,2013,0,0,0,0,0,0,COMPUTER
WEST BENGAL,COUNTERFEITING-PROPERTY ,2013,0,0,0,0,0,0,COMPUTER
TOT (STATES),COUNTERFEITING-PROPERTY ,2013,0,8,15,9,2,34,COMPUTER
A & N ISLANDS,COUNTERFEITING-PROPERTY ,2013,0,0,0,0,0,0,COMPUTER
CHANDIGARH,COUNTERFEITING-PROPERTY ,2013,0,0,0,0,0,0,COMPUTER
D & N HAVELI,COUNTERFEITING-PROPERTY ,2013,0,0,0,0,0,0,COMPUTER
DAMAN & DIU,COUNTERFEITING-PROPERTY ,2013,0,0,0,0,0,0,COMPUTER
DELHI,COUNTERFEITING-PROPERTY ,2013,0,0,0,0,0,0,COMPUTER
LAKSHADWEEP,COUNTERFEITING-PROPERTY ,2013,0,0,0,0,0,0,COMPUTER
PUDUCHERRY,COUNTERFEITING-PROPERTY ,2013,0,0,0,0,0,0,COMPUTER
TOT (UTS),COUNTERFEITING-PROPERTY ,2013,0,0,0,0,0,0,COMPUTER
TOT (ALL INDIA),COUNTERFEITING-PROPERTY ,2013,0,8,15,9,2,34,COMPUTER
ANDHRA PRADESH,COUNTERFEITING-TAMPERING ,2013,0,2,3,5,0,10,COMPUTER
ARUNACHAL PRADESH,COUNTERFEITING-TAMPERING ,2013,0,0,0,0,0,0,COMPUTER
ASSAM,COUNTERFEITING-TAMPERING ,2013,0,0,0,0,0,0,COMPUTER
BIHAR,COUNTERFEITING-TAMPERING ,2013,0,0,0,0,0,0,COMPUTER
CHHATTISGARH,COUNTERFEITING-TAMPERING ,2013,0,0,0,0,0,0,COMPUTER
GOA,COUNTERFEITING-TAMPERING ,2013,0,0,0,0,0,0,COMPUTER
GUJARAT,COUNTERFEITING-TAMPERING ,2013,0,0,0,0,0,0,COMPUTER
HARYANA,COUNTERFEITING-TAMPERING ,2013,0,0,0,0,0,0,COMPUTER
HIMACHAL PRADESH,COUNTERFEITING-TAMPERING ,2013,0,0,0,0,0,0,COMPUTER
JAMMU & KASHMIR,COUNTERFEITING-TAMPERING ,2013,0,0,0,0,0,0,COMPUTER
JHARKHAND,COUNTERFEITING-TAMPERING ,2013,0,0,0,0,0,0,COMPUTER
KARNATAKA,COUNTERFEITING-TAMPERING ,2013,0,0,0,0,0,0,COMPUTER
KERALA,COUNTERFEITING-TAMPERING ,2013,0,0,0,0,0,0,COMPUTER
MADHYA PRADESH,COUNTERFEITING-TAMPERING ,2013,0,0,0,0,0,0,COMPUTER
MAHARASHTRA,COUNTERFEITING-TAMPERING ,2013,0,0,0,0,0,0,COMPUTER
MANIPUR,COUNTERFEITING-TAMPERING ,2013,0,0,0,0,0,0,COMPUTER
MEGHALAYA,COUNTERFEITING-TAMPERING ,2013,0,0,0,0,0,0,COMPUTER
MIZORAM,COUNTERFEITING-TAMPERING ,2013,0,0,0,0,0,0,COMPUTER
NAGALAND,COUNTERFEITING-TAMPERING ,2013,0,0,0,0,0,0,COMPUTER
ORISSA,COUNTERFEITING-TAMPERING ,2013,0,0,0,0,0,0,COMPUTER
PUNJAB,COUNTERFEITING-TAMPERING ,2013,0,0,0,0,0,0,COMPUTER
RAJASTHAN,COUNTERFEITING-TAMPERING ,2013,0,0,0,0,0,0,COMPUTER
SIKKIM,COUNTERFEITING-TAMPERING ,2013,0,0,0,0,0,0,COMPUTER
TAMIL NADU,COUNTERFEITING-TAMPERING ,2013,0,0,0,0,0,0,COMPUTER
TRIPURA,COUNTERFEITING-TAMPERING ,2013,0,0,0,0,0,0,COMPUTER
UTTAR PRADESH,COUNTERFEITING-TAMPERING ,2013,0,0,0,0,0,0,COMPUTER
UTTARAKHAND,COUNTERFEITING-TAMPERING ,2013,0,0,0,0,0,0,COMPUTER
WEST BENGAL,COUNTERFEITING-TAMPERING ,2013,0,0,0,0,0,0,COMPUTER
TOT (STATES),COUNTERFEITING-TAMPERING ,2013,0,2,3,5,0,10,COMPUTER
A & N ISLANDS,COUNTERFEITING-TAMPERING ,2013,0,0,0,0,0,0,COMPUTER
CHANDIGARH,COUNTERFEITING-TAMPERING ,2013,0,0,0,0,0,0,COMPUTER
D & N HAVELI,COUNTERFEITING-TAMPERING ,2013,0,0,0,0,0,0,COMPUTER
DAMAN & DIU,COUNTERFEITING-TAMPERING ,2013,0,0,0,0,0,0,COMPUTER
DELHI,COUNTERFEITING-TAMPERING ,2013,0,0,0,0,0,0,COMPUTER
LAKSHADWEEP,COUNTERFEITING-TAMPERING ,2013,0,0,0,0,0,0,COMPUTER
PUDUCHERRY,COUNTERFEITING-TAMPERING ,2013,0,0,0,0,0,0,COMPUTER
TOT (UTS),COUNTERFEITING-TAMPERING ,2013,0,0,0,0,0,0,COMPUTER
TOT (ALL INDIA),COUNTERFEITING-TAMPERING ,2013,0,2,3,5,0,10,COMPUTER
ANDHRA PRADESH,COUNTERFEITING-CURRENCY,2013,0,0,0,0,0,0,COMPUTER
ARUNACHAL PRADESH,COUNTERFEITING-CURRENCY,2013,0,0,0,0,0,0,COMPUTER
ASSAM,COUNTERFEITING-CURRENCY,2013,0,0,0,0,0,0,COMPUTER
BIHAR,COUNTERFEITING-CURRENCY,2013,0,0,0,0,0,0,COMPUTER
CHHATTISGARH,COUNTERFEITING-CURRENCY,2013,0,0,0,0,0,0,COMPUTER
GOA,COUNTERFEITING-CURRENCY,2013,0,0,0,0,0,0,COMPUTER
GUJARAT,COUNTERFEITING-CURRENCY,2013,0,2,0,0,0,2,COMPUTER
HARYANA,COUNTERFEITING-CURRENCY,2013,0,2,3,0,0,5,COMPUTER
HIMACHAL PRADESH,COUNTERFEITING-CURRENCY,2013,0,0,0,0,0,0,COMPUTER
JAMMU & KASHMIR,COUNTERFEITING-CURRENCY,2013,0,0,0,0,0,0,COMPUTER
JHARKHAND,COUNTERFEITING-CURRENCY,2013,0,0,0,0,0,0,COMPUTER
KARNATAKA,COUNTERFEITING-CURRENCY,2013,0,3,3,0,2,8,COMPUTER
KERALA,COUNTERFEITING-CURRENCY,2013,0,0,0,0,0,0,COMPUTER
MADHYA PRADESH,COUNTERFEITING-CURRENCY,2013,0,0,0,0,0,0,COMPUTER
MAHARASHTRA,COUNTERFEITING-CURRENCY,2013,0,0,0,0,0,0,COMPUTER
MANIPUR,COUNTERFEITING-CURRENCY,2013,0,0,0,0,0,0,COMPUTER
MEGHALAYA,COUNTERFEITING-CURRENCY,2013,0,0,0,0,0,0,COMPUTER
MIZORAM,COUNTERFEITING-CURRENCY,2013,0,0,0,0,0,0,COMPUTER
NAGALAND,COUNTERFEITING-CURRENCY,2013,0,0,0,0,0,0,COMPUTER
ORISSA,COUNTERFEITING-CURRENCY,2013,0,0,0,0,0,0,COMPUTER
PUNJAB,COUNTERFEITING-CURRENCY,2013,0,0,1,2,0,3,COMPUTER
RAJASTHAN,COUNTERFEITING-CURRENCY,2013,0,0,0,0,0,0,COMPUTER
SIKKIM,COUNTERFEITING-CURRENCY,2013,0,0,0,0,0,0,COMPUTER
TAMIL NADU,COUNTERFEITING-CURRENCY,2013,0,0,0,0,0,0,COMPUTER
TRIPURA,COUNTERFEITING-CURRENCY,2013,0,0,0,0,0,0,COMPUTER
UTTAR PRADESH,COUNTERFEITING-CURRENCY,2013,0,0,0,0,0,0,COMPUTER
UTTARAKHAND,COUNTERFEITING-CURRENCY,2013,0,0,0,0,0,0,COMPUTER
WEST BENGAL,COUNTERFEITING-CURRENCY,2013,0,12,12,7,0,31,COMPUTER
TOT (STATES),COUNTERFEITING-CURRENCY,2013,0,19,19,9,2,49,COMPUTER
A & N ISLANDS,COUNTERFEITING-CURRENCY,2013,0,0,0,0,0,0,COMPUTER
CHANDIGARH,COUNTERFEITING-CURRENCY,2013,0,0,0,0,0,0,COMPUTER
D & N HAVELI,COUNTERFEITING-CURRENCY,2013,0,0,0,0,0,0,COMPUTER
DAMAN & DIU,COUNTERFEITING-CURRENCY,2013,0,0,0,0,0,0,COMPUTER
DELHI,COUNTERFEITING-CURRENCY,2013,0,0,0,0,0,0,COMPUTER
LAKSHADWEEP,COUNTERFEITING-CURRENCY,2013,0,0,0,0,0,0,COMPUTER
PUDUCHERRY,COUNTERFEITING-CURRENCY,2013,0,0,0,0,0,0,COMPUTER
TOT (UTS),COUNTERFEITING-CURRENCY,2013,0,0,0,0,0,0,COMPUTER
TOT (ALL INDIA),COUNTERFEITING-CURRENCY,2013,0,19,19,9,2,49,COMPUTER
ANDHRA PRADESH,CYBER-CRIME,2013,0,4,8,5,0,17,COMPUTER
ARUNACHAL PRADESH,CYBER-CRIME,2013,0,0,0,0,0,0,COMPUTER
ASSAM,CYBER-CRIME,2013,0,0,0,0,0,0,COMPUTER
BIHAR,CYBER-CRIME,2013,0,7,196,4,0,207,COMPUTER
CHHATTISGARH,CYBER-CRIME,2013,0,3,7,5,0,15,COMPUTER
GOA,CYBER-CRIME,2013,0,0,1,0,0,1,COMPUTER
GUJARAT,CYBER-CRIME,2013,0,8,6,0,0,14,COMPUTER
HARYANA,CYBER-CRIME,2013,0,44,61,28,3,136,COMPUTER
HIMACHAL PRADESH,CYBER-CRIME,2013,0,0,0,0,0,0,COMPUTER
JAMMU & KASHMIR,CYBER-CRIME,2013,0,0,0,0,0,0,COMPUTER
JHARKHAND,CYBER-CRIME,2013,0,13,0,0,0,13,COMPUTER
KARNATAKA,CYBER-CRIME,2013,0,4,4,0,2,10,COMPUTER
KERALA,CYBER-CRIME,2013,0,7,3,8,0,18,COMPUTER
MADHYA PRADESH,CYBER-CRIME,2013,0,9,2,1,0,12,COMPUTER
MAHARASHTRA,CYBER-CRIME,2013,0,64,93,19,1,177,COMPUTER
MANIPUR,CYBER-CRIME,2013,0,0,0,0,0,0,COMPUTER
MEGHALAYA,CYBER-CRIME,2013,0,0,0,0,0,0,COMPUTER
MIZORAM,CYBER-CRIME,2013,0,0,0,0,0,0,COMPUTER
NAGALAND,CYBER-CRIME,2013,0,0,0,0,0,0,COMPUTER
ORISSA,CYBER-CRIME,2013,0,3,16,2,0,21,COMPUTER
PUNJAB,CYBER-CRIME,2013,0,0,7,3,0,10,COMPUTER
RAJASTHAN,CYBER-CRIME,2013,0,12,4,0,0,16,COMPUTER
SIKKIM,CYBER-CRIME,2013,0,0,0,0,0,0,COMPUTER
TAMIL NADU,CYBER-CRIME,2013,0,24,22,6,2,54,COMPUTER
TRIPURA,CYBER-CRIME,2013,0,0,0,0,0,0,COMPUTER
UTTAR PRADESH,CYBER-CRIME,2013,0,204,99,16,0,319,COMPUTER
UTTARAKHAND,CYBER-CRIME,2013,0,1,2,0,0,3,COMPUTER
WEST BENGAL,CYBER-CRIME,2013,0,39,67,45,0,151,COMPUTER
TOT (STATES),CYBER-CRIME,2013,0,446,598,142,8,1194,COMPUTER
A & N ISLANDS,CYBER-CRIME,2013,0,0,0,0,0,0,COMPUTER
CHANDIGARH,CYBER-CRIME,2013,0,2,0,0,0,2,COMPUTER
D & N HAVELI,CYBER-CRIME,2013,0,0,0,0,0,0,COMPUTER
DAMAN & DIU,CYBER-CRIME,2013,0,0,0,0,0,0,COMPUTER
DELHI,CYBER-CRIME,2013,0,0,5,2,0,7,COMPUTER
LAKSHADWEEP,CYBER-CRIME,2013,0,0,0,0,0,0,COMPUTER
PUDUCHERRY,CYBER-CRIME,2013,0,0,0,0,0,0,COMPUTER
TOT (UTS),CYBER-CRIME,2013,0,2,5,2,0,9,COMPUTER
TOT (ALL INDIA),CYBER-CRIME,2013,0,448,603,144,8,1203,COMPUTER
